秋 の 田 の 仮 庵 の 庵 の 苫 を あ ら み	わ が 衣 手 は 露 に ぬ れ つ つ
春 過 ぎ て 夏 来 に け ら し 白 妙 の	衣 ほ す て ふ 天 の 香 具 山
あ し び き の 山 鳥 の 尾 の し だ り 尾 の	な が な が し 夜 を ひ と り か も 寝 む
田 子 の 浦 に う ち 出 で て み れ ば 白 妙 の	富 士 の 高 嶺 に 雪 は 降 り つ つ
奥 山 に 紅 葉 踏 み わ け 鳴 く 鹿 の	声 き く 時 ぞ 秋 は 悲 し き
か さ さ ぎ の 渡 せ る 橋 に お く 霜 の	白 き を み れ ば 夜 ぞ ふ け に け る
天 の 原 ふ り さ け 見 れ ば 春 日 な る	三 笠 の 山 に 出 で し 月 か も
わ が 庵 は 都 の た つ み し か ぞ す む	世 を う ぢ 山 と 人 は い ふ な り
花 の 色 は う つ り に け り な い た づ ら に	わ が 身 世 に ふ る な が め せ し ま に
こ れ や こ の 行 く も 帰 る も 別 れ て は	知 る も 知 ら ぬ も 逢 坂 の 関
わ た の 原 八 十 島 か け て 漕 ぎ 出 で ぬ と	人 に は 告 げ よ 海 人 の 釣 舟
天 つ 風 雲 の 通 ひ 路 吹 き 閉 ぢ よ	を と め の 姿 し ば し と ど め む
筑 波 嶺 の 峰 よ り 落 つ る 男 女 川	恋 ぞ つ も り て 淵 と な り ぬ る
陸 奥 の し の ぶ も ぢ ず り 誰 ゆ え に	乱 れ そ め に し わ れ な ら な く に
君 が た め 春 の 野 に 出 で て 若 菜 つ む	わ が 衣 手 に 雪 は 降 り つ つ
た ち 別 れ い な ば の 山 の 峰 に 生 ふ る	ま つ と し 聞 か ば 今 帰 り 来 む
ち は や ぶ る 神 代 も 聞 か ず 竜 田 川	か ら く れ な ゐ に 水 く く る と は
住 の 江 の 岸 に よ る 波 よ る さ へ や	夢 の 通 ひ 路 人 め よ く ら む
難 波 潟 み じ か き 芦 の ふ し の 間 も	逢 は で こ の 世 を 過 ぐ し て よ と や
わ び ぬ れ ば 今 は た 同 じ 難 波 な る	み を つ く し て も 逢 は む と ぞ 思 ふ
今 来 む と 言 ひ し ば か り に 長 月 の	有 明 の 月 を 待 ち 出 で つ る か な
吹 く か ら に 秋 の 草 木 の し を る れ ば	む べ 山 風 を 嵐 と い ふ ら む
月 み れ ば ち ぢ に も の こ そ 悲 し け れ	わ が 身 一 つ の 秋 に は あ ら ね ど
こ の た び は ぬ さ も と り あ へ ず 手 向 山	紅 葉 の 錦 神 の ま に ま に
名 に し お は ば 逢 坂 山 の さ ね か づ ら	人 に し ら れ で く る よ し も が な
小 倉 山 峰 の も み ぢ 葉 心 あ ら ば	今 ひ と た び の み ゆ き 待 た な む
み か の 原 わ き て 流 る る 泉 川	い つ 見 き と て か 恋 し か る ら む
山 里 は 冬 ぞ さ び し さ ま さ り け る	人 目 も 草 も か れ ぬ と 思 へ ば
心 あ て に 折 ら ば や 折 ら む 初 霜 の	置 き ま ど は せ る 白 菊 の 花
有 明 の つ れ な く 見 え し 別 れ よ り	あ か つ き ば か り 憂 き も の は な し
朝 ぼ ら け 有 明 の 月 と み る ま で に	吉 野 の 里 に ふ れ る 白 雪
山 川 に 風 の か け た る し ら が み は	流 れ も あ へ ぬ 紅 葉 な り け り
ひ さ か た の 光 の ど け き 春 の 日 に	静 心 な く 花 の 散 る ら む
誰 を か も 知 る 人 に せ む 高 砂 の	松 も 昔 の 友 な ら な く に
人 は い さ 心 も 知 ら ず ふ る さ と は	花 ぞ 昔 の 香 に に ほ ひ け る
夏 の 夜 は ま だ 宵 な が ら 明 け ぬ る を	雲 の い づ こ に 月 や ど る ら む
白 露 に 風 の 吹 き し く 秋 の 野 は	つ ら ぬ き と め ぬ 玉 ぞ 散 り け る
忘 ら る る 身 を ば 思 は ず 誓 ひ て し	人 の 命 の 惜 し く も あ る か な
浅 茅 生 の 小 野 の 篠 原 し の ぶ れ ど	あ ま り て な ど か 人 の 恋 し き
し の ぶ れ ど 色 に 出 で に け り わ が 恋 は	も の や 思 ふ と 人 の 問 ふ ま で
恋 す て ふ わ が 名 は ま だ き 立 ち に け り	人 知 れ ず こ そ 思 ひ そ め し か
契 り き な か た み に 袖 を し ぼ り つ つ	末 の 松 山 波 越 さ じ と は
逢 ひ 見 て の の ち の 心 に く ら ぶ れ ば	昔 は も の を 思 は ざ り け り
逢 ふ こ と の 絶 え て し な く は な か な か に	人 を も 身 を も 恨 み ざ ら ま し
あ は れ と も い ふ べ き 人 は 思 ほ え で	身 の い た づ ら に な り ぬ べ き か な
由 良 の と を 渡 る 舟 人 か ぢ を た え	行 く へ も 知 ら ぬ 恋 の 道 か な
八 重 葎 し げ れ る 宿 の さ び し き に	人 こ そ 見 え ね 秋 は 来 に け り
風 を い た み 岩 う つ 波 の お の れ の み	く だ け て も の を 思 ふ こ ろ か な
み か き も り 衛 士 の た く 火 の 夜 は 燃 え	昼 は 消 え つ つ も の を こ そ 思 へ
君 が た め 惜 し か ら ざ り し 命 さ へ	長 く も が な と 思 ひ け る か な
か く と だ に え は や い ぶ き の さ し も 草	さ し も 知 ら じ な 燃 ゆ る 思 ひ を
明 け ぬ れ ば 暮 る る も の と は 知 り な が ら	な ほ う ら め し き 朝 ぼ ら け か な
嘆 き つ つ ひ と り 寝 る 夜 の 明 く る 間 は	い か に 久 し き も の と か は 知 る
忘 れ じ の 行 く 末 ま で は か た け れ ば	今 日 を 限 り の 命 と も が な
滝 の 音 は 絶 え て 久 し く な り ぬ れ ど	名 こ そ 流 れ て な ほ 聞 こ え け れ
あ ら ざ ら む こ の 世 の ほ か の 思 ひ 出 に	今 ひ と た び の 逢 ふ こ と も が な
め ぐ り あ ひ て 見 し や そ れ と も わ か ぬ 間 に	雲 が く れ に し 世 半 の 月 か な
有 馬 山 猪 名 の 笹 原 風 吹 け ば	い で そ よ 人 を 忘 れ や は す る
や す ら は で 寝 な ま し も の を さ 夜 ふ け て	か た ぶ く ま で の 月 を 見 し か な
大 江 山 い く 野 の 道 の 遠 け れ ば	ま だ ふ み も み ず 天 の 橋 立
い に し へ の 奈 良 の 都 の 八 重 桜	け ふ 九 重 に に ほ ひ ぬ る か な
夜 を こ め て 鳥 の そ ら ね は は か る と も	よ に 逢 坂 の 関 は ゆ る さ じ
今 は た だ 思 ひ 絶 え な む と ば か り を	人 づ て な ら で 言 ふ よ し も が な
朝 ぼ ら け 宇 治 の 川 霧 た え だ え に	あ ら は れ わ た る 瀬 々 の 網 代 木
恨 み わ び ほ さ ぬ 袖 だ に あ る も の を	恋 に 朽 ち な む 名 こ そ 惜 し け れ
も ろ と も に あ は れ と 思 へ 山 桜	花 よ り ほ か に 知 る 人 も な し
春 の 夜 の 夢 ば か り な る 手 枕 に	か ひ な く 立 た む 名 こ そ 惜 し け れ
心 に も あ ら で う き 世 に な が ら へ ば	恋 し か る べ き 夜 半 の 月 か な
嵐 吹 く 三 室 の 山 の も み ぢ 葉 は	竜 田 の 川 の 錦 な り け り
さ び し さ に 宿 を 立 ち 出 で て な が む れ ば	い づ こ も 同 じ 秋 の 夕 暮 れ
夕 さ れ ば 門 田 の 稲 葉 お と づ れ て	芦 の ま ろ や に 秋 風 ぞ 吹 く
音 に 聞 く 高 師 の 浜 の あ だ 波 は	か け じ や 袖 の ぬ れ も こ そ す れ
高 砂 の 尾 の 上 の 桜 咲 き に け り	外 山 の 霞 立 た ず も あ ら な む
憂 か り け る 人 を 初 瀬 の 山 お ろ し よ	は げ し か れ と は 祈 ら ぬ も の を
契 り お き し さ せ も が 露 を 命 に て	あ は れ 今 年 の 秋 も い ぬ め り
わ た の 原 漕 ぎ 出 で て 見 れ ば ひ さ か た の	雲 居 に ま が ふ 沖 つ 白 波
瀬 を は や み 岩 に せ か る る 滝 川 の	わ れ て も 末 に あ は む と ぞ 思 ふ
淡 路 島 か よ ふ 千 鳥 の 鳴 く 声 に	い く 夜 寝 ざ め ね 須 磨 の 関 守
秋 風 に た な び く 雲 の 絶 え 間 よ り	も れ 出 づ る 月 の 影 の さ や け さ
長 か ら む 心 も 知 ら ず 黒 髪 の	乱 れ て 今 朝 は も の を こ そ 思 へ
ほ と と ぎ す 鳴 き つ る 方 を な が む れ ば	た だ 有 明 の 月 ぞ 残 れ る
思 ひ わ び さ て も 命 は あ る も の を	憂 き に た へ ぬ は 涙 な り け り
世 の 中 よ 道 こ そ な け れ 思 ひ 入 る	山 の 奥 に も 鹿 ぞ 鳴 く な る
な が ら へ ば ま た こ の ご ろ や し の ば れ む	憂 し と み し 世 ぞ 今 は 恋 し き
夜 も す が ら も の 思 ふ こ ろ は 明 け や ら で	閨 の ひ ま さ へ つ れ な か り け り
嘆 け と て 月 や は も の を 思 は す る	か こ ち 顔 な る わ が 涙 か な
村 雨 の 露 も ま だ ひ ぬ 真 木 の 葉 に	霧 立 ち の ぼ る 秋 の 夕 暮 れ
難 波 江 の 芦 の か り ね の ひ と よ ゆ ゑ	み を つ く し て や 恋 ひ わ た る べ き
玉 の 緒 よ 絶 え ね ば 絶 え ね な が ら へ ば	忍 ぶ る こ と の よ わ り も ぞ す る
見 せ ば や な 雄 島 の あ ま の 袖 だ に も	ぬ れ に ぞ ぬ れ し 色 は か は ら ず
