年 の 内 に 春 は き に け り ひ と と せ を 	去 年 と や 言 は む 今 年 と や 言 は む 
袖 ひ ち て む す び し 水 の こ ほ れ る を 	春 立 つ 今 日 の 風 や と く ら む 
春 霞 立 て る や い づ こ み 吉 野 の 	吉 野 の 山 に 雪 は 降 り つ つ 
雪 の 内 に 春 は き に け り う ぐ ひ す の 	こ ほ れ る 涙 今 や と く ら む 
梅 が 枝 に き ゐ る う ぐ ひ す 春 か け て 	鳴 け ど も 今 だ 雪 は 降 り つ つ 
春 た て ば 花 と や 見 ら む 白 雪 の 	か か れ る 枝 に う ぐ ひ す の 鳴 く 
心 ざ し 深 く 染 め て し 折 り け れ ば 	消 え あ へ ぬ 雪 の 花 と 見 ゆ ら む 
春 の 日 の 光 に 当 た る 我 な れ ど 	か し ら の 雪 と な る ぞ わ び し き 
霞 立 ち 木 の 芽 も は る の 雪 降 れ ば 	花 な き 里 も 花 ぞ 散 り け る 
春 や と き 花 や お そ き と 聞 き わ か む 	う ぐ ひ す だ に も 鳴 か ず も あ る か な 
春 き ぬ と 人 は 言 へ ど も う ぐ ひ す の 	鳴 か ぬ か ぎ り は あ ら じ と ぞ 思 ふ 
谷 風 に と く る 氷 の ひ ま ご と に 	う ち 出 づ る 浪 や 春 の 初 花 
花 の 香 を 風 の た よ り に た ぐ へ て ぞ 	う ぐ ひ す さ そ ふ し る べ に は や る 
う ぐ ひ す の 谷 よ り い づ る 声 な く は 	春 く る こ と を 誰 か 知 ら ま し 
春 た て ど 花 も 匂 は ぬ 山 里 は 	も の う か る ね に う ぐ ひ す ぞ 鳴 く 
野 辺 近 く い へ ゐ し せ れ ば う ぐ ひ す の 	鳴 く な る 声 は 朝 な 朝 な 聞 く 
春 日 野 は 今 日 は な 焼 き そ 若 草 の 	つ ま も こ も れ り 我 も こ も れ り 
春 日 野 の と ぶ ひ の 野 守 い で て 見 よ 	今 い く か あ り て 若 菜 つ み て む 
み 山 に は 松 の 雪 だ に 消 え な く に 	み や こ は 野 辺 の 若 菜 つ み け り 
梓 弓 押 し て は る さ め 今 日 降 り ぬ 	明 日 さ へ 降 ら ば 若 菜 つ み て む 
君 が た め 春 の 野 に い で て 若 菜 つ む 	我 が 衣 手 に 雪 は 降 り つ つ 
春 日 野 の 若 菜 つ み に や 白 妙 の 	袖 ふ り は へ て 人 の ゆ く ら む 
春 の 着 る 霞 の 衣 ぬ き を 薄 み 	山 風 に こ そ 乱 る べ ら な れ 
と き は な る 松 の 緑 も 春 く れ ば 	今 ひ と し ほ の 色 ま さ り け り 
我 が 背 子 が 衣 は る さ め ふ る ご と に 	野 辺 の 緑 ぞ 色 ま さ り け る 
青 柳 の 糸 よ り か く る 春 し も ぞ 	乱 れ て 花 の ほ こ ろ び に け る 
浅 緑 糸 よ り か け て 白 露 を 	珠 に も ぬ け る 春 の 柳 か 
も も ち ど り さ へ づ る 春 は も の ご と に 	あ ら た ま れ ど も 我 ぞ ふ り ゆ く 
を ち こ ち の た づ き も 知 ら ぬ 山 な か に 	お ぼ つ か な く も 呼 子 鳥 か な 
春 く れ ば 雁 か へ る な り 白 雲 の 	道 ゆ き ぶ り に こ と や つ て ま し 
春 霞 立 つ を 見 捨 て て ゆ く 雁 は 	花 な き 里 に 住 み や な ら へ る 
折 り つ れ ば 袖 こ そ 匂 へ 梅 の 花 	あ り と や こ こ に う ぐ ひ す の 鳴 く 
色 よ り も 香 こ そ あ は れ と 思 ほ ゆ れ 	た が 袖 ふ れ し 宿 の 梅 ぞ も 
宿 近 く 梅 の 花 植 ゑ じ あ ぢ き な く 	待 つ 人 の 香 に あ や ま た れ け り 
梅 の 花 立 ち 寄 る ば か り あ り し よ り 	人 の と が む る 香 に ぞ し み ぬ る 
う ぐ ひ す の 笠 に ぬ ふ て ふ 梅 の 花 	折 り て か ざ さ む 老 い か く る や と 
よ そ に の み あ は れ と ぞ 見 し 梅 の 花 	あ か ぬ 色 か は 折 り て な り け り 
君 な ら で 誰 に か 見 せ む 梅 の 花 	色 を も 香 か を も 知 る 人 ぞ 知 る 
梅 の 花 匂 ふ 春 べ は く ら ぶ 山 	闇 に 越 ゆ れ ど し る く ぞ あ り け る 
月 夜 に は そ れ と も 見 え ず 梅 の 花 	香 を た づ ね て ぞ 知 る べ か り け る 
春 の 夜 の 闇 は あ や な し 梅 の 花 	色 こ そ 見 え ね 香 や は 隠 る る 
人 は い さ 心 も 知 ら ず ふ る さ と は 	花 ぞ 昔 の 香 に 匂 ひ け る 
春 ご と に 流 る る 川 を 花 と 見 て 	折 ら れ ぬ 水 に 袖 や 濡 れ な む 
年 を へ て 花 の 鏡 と な る 水 は 	散 り か か る を や 曇 る と 言 ふ ら む 
く る と あ く と 目 か れ ぬ も の を 梅 の 花 	い つ の 人 ま に う つ ろ ひ ぬ ら む 
梅 が 香 を 袖 に う つ し て と ど め て は 	春 は す ぐ と も 形 見 な ら ま し 
散 る と 見 て あ る べ き も の を 梅 の 花 	う た て 匂 ひ の 袖 に と ま れ る 
散 り ぬ と も 香 を だ に 残 せ 梅 の 花 	恋 し き 時 の 思 ひ 出 に せ む 
今 年 よ り 春 知 り そ む る 桜 花 	散 る と 言 ふ こ と は な ら は ざ ら な む 
山 高 み 人 も す さ め ぬ 桜 花 	い た く な わ び そ 我 見 は や さ む 
山 桜 我 が 見 に く れ ば 春 霞 	峰 に も を に も 立 ち 隠 し つ つ 
年 ふ れ ば よ は ひ は 老 い ぬ し か は あ れ ど 	花 を し 見 れ ば 物 思 ひ も な し 
世 の 中 に 絶 え て 桜 の な か り せ ば 	春 の 心 は の ど け か ら ま し 
石 ば し る 滝 な く も が な 桜 花 	手 折 り て も こ む 見 ぬ 人 の た め 
見 て の み や 人 に か た ら む 桜 花 	手 ご と に 折 り て い へ づ と に せ む 
見 渡 せ ば 柳 桜 を こ き ま ぜ て 	み や こ ぞ 春 の 錦 な り け る 
色 も 香 も 同 じ 昔 に さ く ら め ど 	年 ふ る 人 ぞ あ ら た ま り け る 
誰 し か も と め て 折 り つ る 春 霞 	立 ち 隠 す ら む 山 の 桜 を 
桜 花 さ き に け ら し な あ し ひ き の 	山 の か ひ よ り 見 ゆ る 白 雲 
み 吉 野 の 山 辺 に さ け る 桜 花 	雪 か と の み ぞ あ や ま た れ け る 
桜 花 春 く は は れ る 年 だ に も 	人 の 心 に あ か れ や は せ ぬ 
あ だ な り と 名 に こ そ た て れ 桜 花 	年 に ま れ な る 人 も 待 ち け り 
今 日 こ ず は 明 日 は 雪 と ぞ 降 り な ま し 	消 え ず は あ り と も 花 と 見 ま し や 
散 り ぬ れ ば 恋 ふ れ ど し る し な き も の を 	今 日 こ そ 桜 折 ら ば 折 り て め 
折 り と ら ば 惜 し げ に も あ る か 桜 花 	い ざ 宿 か り て 散 る ま で は 見 む 
桜 色 に 衣 は 深 く 染 め て 着 む 	花 の 散 り な む の ち の 形 見 に 
我 が 宿 の 花 見 が て ら に く る 人 は 	散 り な む の ち ぞ 恋 し か る べ き 
見 る 人 も な き 山 里 の 桜 花 	ほ か の 散 り な む の ち ぞ 咲 か ま し 
春 霞 た な び く 山 の 桜 花 	う つ ろ は む と や 色 か は り ゆ く 
待 て と 言 ふ に 散 ら で し と ま る も の な ら ば 	何 を 桜 に 思 ひ ま さ ま し 
残 り な く 散 る ぞ め で た き 桜 花 	あ り て 世 の 中 は て の 憂 け れ ば 
こ の 里 に 旅 寝 し ぬ べ し 桜 花 	散 り の ま が ひ に 家 路 忘 れ て 
空 蝉 の 世 に も 似 た る か 花 桜 	咲 く と 見 し ま に か つ 散 り に け り 
桜 花 散 ら ば 散 ら な む 散 ら ず と て 	ふ る さ と 人 の き て も 見 な く に 
桜 散 る 花 の と こ ろ は 春 な が ら 	雪 ぞ 降 り つ つ 消 え が て に す る 
花 散 ら す 風 の 宿 り は 誰 か 知 る 	我 に 教 へ よ 行 き て う ら み む 
い ざ 桜 我 も 散 り な む ひ と さ か り 	あ り な ば 人 に う き め 見 え な む 
ひ と 目 見 し 君 も や 来 る と 桜 花 	今 日 は 待 ち み て 散 ら ば 散 ら な む 
春 霞 何 隠 す ら む 桜 花 	散 る 間 を だ に も 見 る べ き も の を 
た れ こ め て 春 の ゆ く へ も 知 ら ぬ 間 に 	待 ち し 桜 も う つ ろ ひ に け り 
枝 よ り も あ だ に 散 り に し 花 な れ ば 	落 ち て も 水 の 泡 と こ そ な れ 
こ と な ら ば 咲 か ず や は あ ら ぬ 桜 花 	見 る 我 さ へ に し づ 心 な し 
桜 花 と く 散 り ぬ と も 思 ほ え ず 	人 の 心 ぞ 風 も 吹 き あ へ ぬ 
久 方 の 光 の ど け き 春 の 日 に 	し づ 心 な く 花 の 散 る ら む 
春 風 は 花 の あ た り を よ ぎ て 吹 け 	心 づ か ら や う つ ろ ふ と 見 む 
雪 と の み 降 る だ に あ る を 桜 花 	い か に 散 れ と か 風 の 吹 く ら む 
山 高 み 見 つ つ 我 が こ し 桜 花 	風 は 心 に ま か す べ ら な り 
春 雨 の 降 る は 涙 か 桜 花 	散 る を 惜 し ま ぬ 人 し な け れ ば 
桜 花 散 り ぬ る 風 の な ご り に は 	水 な き 空 に 浪 ぞ た ち け る 
ふ る さ と と な り に し 奈 良 の み や こ に も 	色 は か は ら ず 花 は 咲 き け り 
花 の 色 は 霞 に こ め て 見 せ ず と も 	香 を だ に ぬ す め 春 の 山 風 
花 の 木 も 今 は ほ り 植 ゑ じ 春 た て ば 	う つ ろ ふ 色 に 人 な ら ひ け り 
春 の 色 の い た り い た ら ぬ 里 は あ ら じ 	咲 け る 咲 か ざ る 花 の 見 ゆ ら む 
三 輪 山 を し か も 隠 す か 春 霞 	人 に 知 ら れ ぬ 花 や 咲 く ら む 
い ざ 今 日 は 春 の 山 辺 に ま じ り な む 	暮 れ な ば な げ の 花 の か げ か は 
い つ ま で か 野 辺 に 心 の あ く が れ む 	花 し 散 ら ず は 千 代 も へ ぬ べ し 
春 ご と に 花 の さ か り は あ り な め ど 	あ ひ 見 む こ と は 命 な り け り 
花 の ご と 世 の つ ね な ら ば す ぐ し て し 	昔 は ま た も か へ り き な ま し 
吹 く 風 に あ つ ら へ つ く る も の な ら ば 	こ の ひ と も と は よ ぎ よ と 言 は ま し 
待 つ 人 も 来 ぬ も の ゆ ゑ に う ぐ ひ す の 	鳴 き つ る 花 を 折 り て け る か な 
咲 く 花 は ち ぐ さ な が ら に あ だ な れ ど 	誰 か は 春 を う ら み は て た る 
春 霞 色 の ち ぐ さ に 見 え つ る は 	た な び く 山 の 花 の か げ か も 
霞 立 つ 春 の 山 辺 は 遠 け れ ど 	吹 き く る 風 は 花 の 香 ぞ す る 
花 見 れ ば 心 さ へ に ぞ う つ り け る 	色 に は い で じ 人 も こ そ 知 れ 
う ぐ ひ す の 鳴 く 野 辺 ご と に 来 て 見 れ ば 	う つ ろ ふ 花 に 風 ぞ 吹 き け る 
吹 く 風 を 鳴 き て う ら み よ う ぐ ひ す は 	我 や は 花 に 手 だ に ふ れ た る 
散 る 花 の な く に し と ま る も の な ら ば 	我 う ぐ ひ す に お と ら ま し や は 
花 の 散 る こ と や わ び し き 春 霞 	た つ た の 山 の う ぐ ひ す の 声 
こ づ た へ ば お の が 羽 か ぜ に 散 る 花 を 	誰 に お ほ せ て こ こ ら 鳴 く ら む 
し る し な き 音 を も 鳴 く か な う ぐ ひ す の 	今 年 の み 散 る 花 な ら な く に 
駒 な め て い ざ 見 に ゆ か む ふ る さ と は 	雪 と の み こ そ 花 は 散 る ら め 
散 る 花 を 何 か う ら み む 世 の 中 に 	我 が 身 も 共 に あ ら む も の か は 
花 の 色 は う つ り に け り な い た づ ら に 	わ が 身 世 に ふ る な が め せ し ま に 
惜 し と 思 ふ 心 は 糸 に よ ら れ な む 	散 る 花 ご と に ぬ き て と ど め む 
梓 弓 は る の 山 辺 を 越 え く れ ば 	道 も さ り あ へ ず 花 ぞ 散 り け る 
春 の 野 に 若 菜 つ ま む と こ し も の を 	散 り か ふ 花 に 道 は 惑 ひ ぬ 
宿 り し て 春 の 山 辺 に 寝 た る 夜 は 	夢 の 内 に も 花 ぞ 散 り け る 
吹 く 風 と 谷 の 水 と し な か り せ ば 	み 山 隠 れ の 花 を 見 ま し や 
よ そ に 見 て か へ ら む 人 に 藤 の 花 	は ひ ま つ は れ よ 枝 は 折 る と も 
我 が 宿 に 咲 け る 藤 波 立 ち 返 り 	す ぎ が て に の み 人 の 見 る ら む 
今 も か も 咲 き 匂 ふ ら む 橘 の 	こ じ ま の さ き の 山 吹 の 花 
春 雨 に 匂 へ る 色 も あ か な く に 	香 さ へ な つ か し 山 吹 の 花 
山 吹 は あ や な な 咲 き そ 花 見 む と 	植 ゑ け む 君 が 今 宵 来 な く に 
吉 野 川 岸 の 山 吹 吹 く 風 に 	底 の 影 さ へ う つ ろ ひ に け り 
か は づ な く ゐ で の 山 吹 散 り に け り 	花 の さ か り に あ は ま し も の を 
お も ふ ど ち 春 の 山 辺 に う ち む れ て 	そ こ と も 言 は ぬ 旅 寝 し て し か 
梓 弓 春 た ち し よ り 年 月 の 	い る が ご と く も 思 ほ ゆ る か な 
鳴 き と む る 花 し な け れ ば う ぐ ひ す も 	は て は も の う く な り ぬ べ ら な り 
花 散 れ る 水 の ま に ま に と め く れ ば 	山 に は 春 も な く な り に け り 
惜 し め ど も と ど ま ら な く に 春 霞 	か へ る 道 に し た ち ぬ と 思 へ ば 
声 絶 え ず 鳴 け や う ぐ ひ す ひ と と せ に 	ふ た た び と だ に 来 べ き 春 か は 
と ど む べ き も の と は な し に は か な く も 	散 る 花 ご と に た ぐ ふ 心 か 
濡 れ つ つ ぞ し ひ て 折 り つ る 年 の 内 に 	春 は い く か も あ ら じ と 思 へ ば 
今 日 の み と 春 を 思 は ぬ 時 だ に も 	立 つ こ と や す き 花 の か げ か は 
我 が 宿 の 池 の 藤 波 咲 き に け り 	山 郭 公 い つ か 来 鳴 か む 
あ は れ て ふ こ と を あ ま た に や ら じ と や 	春 に お く れ て ひ と り 咲 く ら む 
五 月 待 つ 山 郭 公 う ち は ぶ き 	今 も 鳴 か な む 去 年 の ふ る 声 
五 月 こ ば 鳴 き も ふ り な む 郭 公 	ま だ し き ほ ど の 声 を 聞 か ば や 
五 月 待 つ 花 橘 の 香 を か げ ば 	昔 の 人 の 袖 の 香 ぞ す る 
い つ の 間 に 五 月 来 ぬ ら む あ し ひ き の 	山 郭 公 今 ぞ 鳴 く な る 
今 朝 き 鳴 き い ま だ 旅 な る 郭 公 	花 橘 に 宿 は か ら な む 
音 羽 山 今 朝 越 え く れ ば 郭 公 	梢 は る か に 今 ぞ 鳴 く な る 
郭 公 初 声 聞 け ば あ ぢ き な く 	主 さ だ ま ら ぬ 恋 せ ら る は た 
い そ の か み ふ る き み や こ の 郭 公 	声 ば か り こ そ 昔 な り け れ 
夏 山 に 鳴 く 郭 公 心 あ ら ば 	物 思 ふ 我 に 声 な 聞 か せ そ 
郭 公 鳴 く 声 聞 け ば 別 れ に し 	ふ る さ と さ へ ぞ 恋 し か り け る 
郭 公 な が 鳴 く 里 の あ ま た あ れ ば 	な ほ う と ま れ ぬ 思 ふ も の か ら 
思 ひ い づ る と き は の 山 の 郭 公 	唐 紅 の ふ り い で て ぞ 鳴 く 
声 は し て 涙 は 見 え ぬ 郭 公 	我 が 衣 手 の ひ つ を か ら な む 
あ し ひ き の 山 郭 公 を り は へ て 	誰 か ま さ る と 音 を の み ぞ 鳴 く 
今 さ ら に 山 へ か へ る な 郭 公 	声 の か ぎ り は 我 が 宿 に 鳴 け 
や よ や ま て 山 郭 公 こ と づ て む 	我 れ 世 の 中 に 住 み わ び ぬ と よ 
五 月 雨 に 物 思 ひ を れ ば 郭 公 	夜 深 く 鳴 き て い づ ち 行 く ら む 
夜 や 暗 き 道 や 惑 へ る 郭 公 	我 が 宿 を し も す ぎ が て に 鳴 く 
宿 り せ し 花 橘 も 枯 れ な く に 	な ど 郭 公 声 絶 え ぬ ら む 
夏 の 夜 の ふ す か と す れ ば 郭 公 	鳴 く ひ と 声 に 明 く る し の の め 
く る る か と 見 れ ば 明 け ぬ る 夏 の 夜 を 	あ か ず と や 鳴 く 山 郭 公 
夏 山 に 恋 し き 人 や 入 り に け む 	声 ふ り た て て 鳴 く 郭 公 
去 年 の 夏 鳴 き ふ る し て し 郭 公 	そ れ か あ ら ぬ か 声 の か は ら ぬ 
五 月 雨 の 空 も と ど ろ に 郭 公 	何 を 憂 し と か 夜 た だ 鳴 く ら む 
郭 公 声 も 聞 こ え ず 山 彦 は 	ほ か に な く 音 を 答 へ や は せ ぬ 
郭 公 人 ま つ 山 に 鳴 く な れ ば 	我 う ち つ け に 恋 ひ ま さ り け り 
昔 べ や 今 も 恋 し き 郭 公 	ふ る さ と に し も 鳴 き て き つ ら む 
郭 公 我 と は な し に 卯 の 花 の 	う き 世 の 中 に 鳴 き 渡 る ら む 
は ち す 葉 の に ご り に し ま ぬ 心 も て 	何 か は 露 を 珠 と あ ざ む く 
夏 の 夜 は ま だ 宵 な が ら 明 け ぬ る を 	雲 の い づ こ に 月 宿 る ら む 
塵 を だ に す ゑ じ と ぞ 思 ふ 咲 き し よ り 	妹 と 我 が 寝 る 常 夏 の 花 
夏 と 秋 と 行 き か ふ 空 の か よ ひ ぢ は 	か た へ 涼 し き 風 や 吹 く ら む 
秋 き ぬ と 目 に は さ や か に 見 え ね ど も 	風 の 音 に ぞ お ど ろ か れ ぬ る 
川 風 の 涼 し く も あ る か う ち よ す る 	浪 と と も に や 秋 は 立 つ ら む 
我 が 背 子 が 衣 の 裾 を 吹 き 返 し 	う ら め づ ら し き 秋 の 初 風 
昨 日 こ そ 早 苗 と り し か い つ の 間 に 	稲 葉 そ よ ぎ て 秋 風 の 吹 く 
秋 風 の 吹 き に し 日 よ り 久 方 の 	天 の 河 原 に 立 た ぬ 日 は な し 
久 方 の 天 の 河 原 の 渡 し 守 	君 渡 り な ば か ぢ か く し て よ 
天 の 河 紅 葉 を 橋 に わ た せ ば や 	七 夕 つ め の 秋 を し も 待 つ 
恋 ひ 恋 ひ て あ ふ 夜 は 今 宵 天 の 河 	霧 立 ち わ た り 明 け ず も あ ら な む 
天 の 河 浅 瀬 し ら 浪 た ど り つ つ 	渡 り は て ね ば 明 け ぞ し に け る 
契 り け む 心 ぞ つ ら き 七 夕 の 	年 に ひ と た び あ ふ は あ ふ か は 
年 ご と に あ ふ と は す れ ど 七 夕 の 	寝 る 夜 の 数 ぞ 少 な か り け る 
七 夕 に か し つ る 糸 の う ち は へ て 	年 の を 長 く 恋 ひ や 渡 ら む 
今 宵 こ む 人 に は あ は じ 七 夕 の 	久 し き ほ ど に 待 ち も こ そ す れ 
今 は と て 別 る る 時 は 天 の 河 	渡 ら ぬ 先 に 袖 ぞ ひ ち ぬ る 
今 日 よ り は 今 こ む 年 の 昨 日 を ぞ 	い つ し か と の み 待 ち 渡 る べ き 
木 の 間 よ り も り く る 月 の 影 見 れ ば 	心 づ く し の 秋 は き に け り 
お ほ か た の 秋 く る か ら に 我 が 身 こ そ 	か な し き も の と 思 ひ 知 り ぬ れ 
我 が た め に く る 秋 に し も あ ら な く に 	虫 の 音 聞 け ば ま づ ぞ か な し き 
も の ご と に 秋 ぞ か な し き も み ぢ つ つ 	う つ ろ ひ ゆ く を か ぎ り と 思 へ ば 
ひ と り 寝 る 床 は 草 葉 に あ ら ね ど も 	秋 く る 宵 は 露 け か り け り 
い つ は と は 時 は わ か ね ど 秋 の 夜 ぞ 	物 思 ふ こ と の か ぎ り な り け る 
か く ば か り 惜 し と 思 ふ 夜 を い た づ ら に 	寝 て 明 か す ら む 人 さ へ ぞ う き 
白 雲 に 羽 う ち か は し 飛 ぶ 雁 の 	数 さ へ 見 ゆ る 秋 の 夜 の 月 
小 夜 中 と 夜 は ふ け ぬ ら し 雁 が ね の 	聞 こ ゆ る 空 に 月 渡 る 見 ゆ 
月 見 れ ば ち ぢ に も の こ そ か な し け れ 	我 が 身 ひ と つ の 秋 に は あ ら ね ど 
久 方 の 月 の 桂 も 秋 は な ほ 	も み ぢ す れ ば や 照 り ま さ る ら む 
秋 の 夜 の 月 の 光 し あ か け れ ば 	く ら ぶ の 山 も 越 え ぬ べ ら な り 
き り ぎ り す い た く な 鳴 き そ 秋 の 夜 の 	長 き 思 ひ は 我 ぞ ま さ れ る 
秋 の 夜 の 明 く る も 知 ら ず 鳴 く 虫 は 	我 が ご と も の や か な し か る ら む 
秋 萩 も 色 づ き ぬ れ ば き り ぎ り す 	我 が 寝 ぬ ご と や 夜 は か な し き 
秋 の 夜 は 露 こ そ こ と に 寒 か ら し 	草 む ら ご と に 虫 の わ ぶ れ ば 
君 し の ぶ 草 に や つ る る ふ る さ と は 	松 虫 の 音 ぞ か な し か り け る 
秋 の 野 に 道 も 惑 ひ ぬ 松 虫 の 	声 す る 方 に 宿 や か ら ま し 
秋 の 野 に 人 ま つ 虫 の 声 す な り 	我 か と ゆ き て い ざ と ぶ ら は む 
も み ぢ 葉 の 散 り て つ も れ る 我 が 宿 に 	誰 を ま つ 虫 こ こ ら 鳴 く ら む 
ひ ぐ ら し の 鳴 き つ る な へ に 日 は 暮 れ ぬ と 	思 ふ は 山 の か げ に ぞ あ り け る 
ひ ぐ ら し の 鳴 く 山 里 の 夕 暮 れ は 	風 よ り ほ か に と ふ 人 も な し 
待 つ 人 に あ ら ぬ も の か ら 初 雁 の 	今 朝 鳴 く 声 の め づ ら し き か な 
秋 風 に 初 雁 が ね ぞ 聞 こ ゆ な る 	た が た ま づ さ を か け て き つ ら む 
我 が 門 に い な お ほ せ 鳥 の 鳴 く な へ に 	今 朝 吹 く 風 に 雁 は き に け り 
い と は や も 鳴 き ぬ る 雁 か 白 露 の 	色 ど る 木 ぎ も も み ぢ あ へ な く に 
春 霞 か す み て い に し 雁 が ね は 	今 ぞ 鳴 く な る 秋 霧 の 上 に 
夜 を 寒 み 衣 か り が ね 鳴 く な へ に 	萩 の 下 葉 も う つ ろ ひ に け り 
秋 風 に 声 を 帆 に あ げ て く る 舟 は 	天 の 門 渡 る 雁 に ぞ あ り け る 
憂 き こ と を 思 ひ つ ら ね て 雁 が ね の 	鳴 き こ そ わ た れ 秋 の 夜 な 夜 な 
山 里 は 秋 こ そ こ と に わ び し け れ 	鹿 の 鳴 く 音 に 目 を 覚 ま し つ つ 
奥 山 に も み ぢ 踏 み わ け 鳴 く 鹿 の 	声 聞 く 時 ぞ 秋 は か な し き 
秋 萩 に う ら び れ を れ ば あ し ひ き の 	山 下 と よ み 鹿 の 鳴 く ら む 
秋 萩 を し が ら み ふ せ て 鳴 く 鹿 の 	目 に は 見 え ず て 音 の さ や け さ 
秋 萩 の 花 咲 き に け り 高 砂 の 	尾 上 の 鹿 は 今 や 鳴 く ら む 
秋 萩 の 古 枝 に 咲 け る 花 見 れ ば 	も と の 心 は 忘 れ ざ り け り 
秋 萩 の 下 葉 色 づ く 今 よ り や 	ひ と り あ る 人 の い ね が て に す る 
鳴 き 渡 る 雁 の 涙 や 落 ち つ ら む 	物 思 ふ 宿 の 萩 の 上 の 露 
萩 の 露 玉 に ぬ か む と と れ ば け ぬ 	よ し 見 む 人 は 枝 な が ら 見 よ 
折 り て み ば 落 ち ぞ し ぬ べ き 秋 萩 の 	枝 も た わ わ に 置 け る 白 露 
萩 が 花 散 る ら む 小 野 の 露 霜 に 	濡 れ て を ゆ か む 小 夜 は ふ く と も 
秋 の 野 に 置 く 白 露 は 玉 な れ や 	つ ら ぬ き か く る く も の 糸 す ぢ 
名 に め で て 折 れ る ば か り ぞ 女 郎 花 	我 お ち に き と 人 に か た る な 
女 郎 花 憂 し と 見 つ つ ぞ ゆ き す ぐ る 	男 山 に し 立 て り と 思 へ ば 
秋 の 野 に 宿 り は す べ し 女 郎 花 	名 を む つ ま じ み 旅 な ら な く に 
女 郎 花 お ほ か る 野 辺 に 宿 り せ ば 	あ や な く あ だ の 名 を や た ち な む 
女 郎 花 秋 の 野 風 に う ち な び き 	心 ひ と つ を 誰 に よ す ら む 
秋 な ら で あ ふ こ と か た き 女 郎 花 	天 の 河 原 に お ひ ぬ も の ゆ ゑ 
た が 秋 に あ ら ぬ も の ゆ ゑ 女 郎 花 	な ぞ 色 に い で て ま だ き う つ ろ ふ 
つ ま 恋 ふ る 鹿 ぞ 鳴 く な る 女 郎 花 	お の が す む 野 の 花 と 知 ら ず や 
女 郎 花 吹 き す ぎ て く る 秋 風 は 	目 に は 見 え ね ど 香 こ そ し る け れ 
人 の 見 る こ と や く る し き 女 郎 花 	秋 霧 に の み 立 ち 隠 る ら む 
ひ と り の み な が む る よ り は 女 郎 花 	我 が 住 む 宿 に 植 ゑ て 見 ま し を 
女 郎 花 う し ろ め た く も 見 ゆ る か な 	荒 れ た る 宿 に ひ と り 立 て れ ば 
花 に あ か で 何 か へ る ら む 女 郎 花 	お ほ か る 野 辺 に 寝 な ま し も の を 
な に 人 か 来 て 脱 ぎ か け し 藤 ば か ま 	来 る 秋 ご と に 野 辺 を 匂 は す 
宿 り せ し 人 の 形 見 か 藤 ば か ま 	忘 ら れ が た き 香 に 匂 ひ つ つ 
主 知 ら ぬ 香 こ そ 匂 へ れ 秋 の 野 に 	た が 脱 ぎ か け し 藤 ば か ま ぞ も 
今 よ り は 植 ゑ て だ に 見 じ 花 薄 	穂 に い づ る 秋 は わ び し か り け り 
秋 の 野 の 草 の 袂 か 花 薄 	穂 に い で て ま ね く 袖 と 見 ゆ ら む 
我 の み や あ は れ と 思 は む き り ぎ り す 	鳴 く 夕 影 の 大 和 撫 子 
緑 な る ひ と つ 草 と ぞ 春 は 見 し 	秋 は 色 い ろ の 花 に ぞ あ り け る 
も も く さ の 花 の ひ も と く 秋 の 野 に 	思 ひ た は れ む 人 な と が め そ 
月 草 に 衣 は す ら む 朝 露 に 	濡 れ て の の ち は う つ ろ ひ ぬ と も 
里 は 荒 れ て 人 は ふ り に し 宿 な れ や 	庭 も ま が き も 秋 の 野 ら な る 
吹 く か ら に 秋 の 草 木 の し を る れ ば 	む べ 山 風 を 嵐 と 言 ふ ら む 
草 も 木 も 色 か は れ ど も わ た つ み の 	浪 の 花 に ぞ 秋 な か り け る 
紅 葉 せ ぬ と き は の 山 は 吹 く 風 の 	音 に や 秋 を 聞 き 渡 る ら む 
霧 立 ち て 雁 ぞ 鳴 く な る 片 岡 の 	朝 の 原 は も み ぢ し ぬ ら む 
神 無 月 時 雨 も い ま だ 降 ら な く に 	か ね て う つ ろ ふ 神 な び の も り 
ち は や ぶ る 神 な び 山 の も み ぢ 葉 に 	思 ひ は か け じ う つ ろ ふ も の を 
同 じ 枝 を わ き て 木 の 葉 の う つ ろ ふ は 	西 こ そ 秋 の は じ め な り け れ 
秋 風 の 吹 き に し 日 よ り 音 羽 山 	峰 の 梢 も 色 づ き に け り 
白 露 の 色 は ひ と つ を い か に し て 	秋 の 木 の 葉 を ち ぢ に 染 む ら む 
秋 の 夜 の 露 を ば 露 と 置 き な が ら 	雁 の 涙 や 野 辺 を 染 む ら む 
秋 の 露 色 い ろ こ と に 置 け ば こ そ 	山 の 木 の 葉 の ち ぐ さ な る ら め 
白 露 も 時 雨 も い た く も る 山 は 	下 葉 残 ら ず 色 づ き に け り 
雨 降 れ ど 露 も も ら じ を 笠 取 り の 	山 は い か で か も み ぢ 染 め け む 
ち は や ぶ る 神 の い が き に は ふ く ず も 	秋 に は あ へ ず う つ ろ ひ に け り 
雨 降 れ ば 笠 取 り 山 の も み ぢ 葉 は 	行 き か ふ 人 の 袖 さ へ ぞ て る 
散 ら ね ど も か ね て ぞ 惜 し き も み ぢ 葉 は 	今 は か ぎ り の 色 と 見 つ れ ば 
誰 が た め の 錦 な れ ば か 秋 霧 の 	佐 保 の 山 辺 を 立 ち 隠 す ら む 
秋 霧 は 今 朝 は な 立 ち そ 佐 保 山 の 	は は そ の も み ぢ よ そ に て も 見 む 
佐 保 山 の は は そ の 色 は 薄 け れ ど 	秋 は 深 く も な り に け る か な 
植 ゑ し 植 ゑ ば 秋 な き 時 や 咲 か ざ ら む 	花 こ そ 散 ら め 根 さ へ 枯 れ め や 
久 方 の 雲 の 上 に て 見 る 菊 は 	天 つ 星 と ぞ あ や ま た れ け る 
露 な が ら 折 り て か ざ さ む 菊 の 花 	老 い せ ぬ 秋 の 久 し か る べ く 
植 ゑ し 時 花 待 ち ど ほ に あ り し 菊 	う つ ろ ふ 秋 に あ は む と や 見 し 
秋 風 の 吹 き 上 げ に 立 て る 白 菊 は 	花 か あ ら ぬ か 浪 の よ す る か 
濡 れ て ほ す 山 路 の 菊 の 露 の 間 に 	い つ か 千 歳 を 我 は へ に け む 
花 見 つ つ 人 待 つ 時 は 白 妙 の 	袖 か と の み ぞ あ や ま た れ け る 
ひ と も と と 思 ひ し 菊 を 大 沢 の 	池 の 底 に も 誰 か 植 ゑ け む 
秋 の 菊 匂 ふ か ぎ り は か ざ し て む 	花 よ り 先 と 知 ら ぬ 我 が 身 を 
心 あ て に 折 ら ば や 折 ら む 初 霜 の 	置 き 惑 は せ る 白 菊 の 花 
色 か は る 秋 の 菊 を ば ひ と と せ に 	ふ た た び 匂 ふ 花 と こ そ 見 れ 
秋 を お き て 時 こ そ あ り け れ 菊 の 花 	う つ ろ ふ か ら に 色 の ま さ れ ば 
咲 き そ め し 宿 し か は れ ば 菊 の 花 	色 さ へ に こ そ う つ ろ ひ に け れ 
佐 保 山 の は は そ の も み ぢ 散 り ぬ べ み 	夜 さ へ 見 よ と 照 ら す 月 影 
奥 山 の い は が き も み ぢ 散 り ぬ べ し 	照 る 日 の 光 見 る 時 な く て 
竜 田 川 も み ぢ 乱 れ て 流 る め り 	渡 ら ば 錦 中 や 絶 え な む 
竜 田 川 も み ぢ 葉 流 る 神 な び の 	み む ろ の 山 に 時 雨 降 る ら し 
恋 し く は 見 て も し の ば む も み ぢ 葉 を 	吹 き な 散 ら し そ 山 お ろ し の 風 
秋 風 に あ へ ず 散 り ぬ る も み ぢ 葉 の 	ゆ く へ さ だ め ぬ 我 ぞ か な し き 
秋 は 来 ぬ 紅 葉 は 宿 に 降 り し き ぬ 	道 踏 み わ け て と ふ 人 は な し 
踏 み わ け て さ ら に や と は む も み ぢ 葉 の 	降 り 隠 し て し 道 と 見 な が ら 
秋 の 月 山 辺 さ や か に 照 ら せ る は 	落 つ る も み ぢ の 数 を 見 よ と か 
吹 く 風 の 色 の ち ぐ さ に 見 え つ る は 	秋 の 木 の 葉 の 散 れ ば な り け り 
霜 の た て 露 の ぬ き こ そ 弱 か ら し 	山 の 錦 の お れ ば か つ 散 る 
わ び 人 の わ き て 立 ち 寄 る 木 の も と は 	た の む か げ な く も み ぢ 散 り け り 
も み ぢ 葉 の 流 れ て と ま る み な と に は 	紅 深 き 浪 や 立 つ ら む 
ち は や ぶ る 神 世 も き か ず 竜 田 川 	唐 紅 に 水 く く る と は 
我 が き つ る 方 も 知 ら れ ず く ら ぶ 山 	木 ぎ の 木 の 葉 の 散 る と ま が ふ に 
神 な び の み む ろ の 山 を 秋 ゆ け ば 	錦 た ち き る 心 地 こ そ す れ 
見 る 人 も な く て 散 り ぬ る 奥 山 の 	紅 葉 は 夜 の 錦 な り け り 
竜 田 姫 た む く る 神 の あ れ ば こ そ 	秋 の 木 の 葉 の ぬ さ と 散 る ら め 
秋 の 山 紅 葉 を ぬ さ と た む く れ ば 	住 む 我 さ へ ぞ 旅 心 地 す る 
神 な び の 山 を す ぎ 行 く 秋 な れ ば 	竜 田 川 に ぞ ぬ さ は た む く る 
白 浪 に 秋 の 木 の 葉 の 浮 か べ る を 	海 人 の 流 せ る 舟 か と ぞ 見 る 
も み ぢ 葉 の 流 れ ざ り せ ば 竜 田 川 	水 の 秋 を ば 誰 か 知 ら ま し 
山 川 に 風 の か け た る し が ら み は 	流 れ も あ へ ぬ 紅 葉 な り け り 
風 吹 け ば 落 つ る も み ぢ 葉 水 清 み 	散 ら ぬ 影 さ へ 底 に 見 え つ つ 
立 ち 止 ま り 見 て を わ た ら む も み ぢ 葉 は 	雨 と 降 る と も 水 は ま さ ら じ 
山 田 も る 秋 の か り い ほ に 置 く 露 は 	い な お ほ せ 鳥 の 涙 な り け り 
穂 に も い で ぬ 山 田 を も る と 藤 衣 	稲 葉 の 露 に 濡 れ ぬ 日 ぞ な き 
刈 れ る 田 に お ふ る ひ つ ち の 穂 に い で ぬ は 	世 を 今 さ ら に あ き は て ぬ と か 
も み ぢ 葉 は 袖 に こ き 入 れ て も て い で な む 	秋 は か ぎ り と 見 む 人 の た め 
み 山 よ り 落 ち く る 水 の 色 見 て ぞ 	秋 は か ぎ り と 思 ひ 知 り ぬ る 
年 ご と に も み ぢ 葉 流 す 竜 田 川 	み な と や 秋 の と ま り な る ら む 
夕 月 夜 小 倉 の 山 に 鳴 く 鹿 の 	声 の 内 に や 秋 は 暮 る ら む 
道 知 ら ば た づ ね も ゆ か む も み ぢ 葉 を 	ぬ さ と た む け て 秋 は い に け り 
竜 田 川 錦 お り か く 神 無 月 	時 雨 の 雨 を た て ぬ き に し て 
山 里 は 冬 ぞ さ び し さ ま さ り け る 	人 目 も 草 も 枯 れ ぬ と 思 へ ば 
大 空 の 月 の 光 し 清 け れ ば 	影 見 し 水 ぞ ま づ こ ほ り け る 
夕 さ れ ば 衣 手 寒 し み 吉 野 の 	吉 野 の 山 に み 雪 降 る ら し 
今 よ り は つ ぎ て 降 ら な む 我 が 宿 の 	薄 お し な み 降 れ る 白 雪 
降 る 雪 は か つ ぞ け ぬ ら し あ し ひ き の 	山 の た ぎ つ 瀬 音 ま さ る な り 
こ の 川 に も み ぢ 葉 流 る 奥 山 の 	雪 げ の 水 ぞ 今 ま さ る ら し 
ふ る さ と は 吉 野 の 山 し 近 け れ ば 	ひ と 日 も み 雪 降 ら ぬ 日 は な し 
我 が 宿 は 雪 降 り し き て 道 も な し 	踏 み わ け て と ふ 人 し な け れ ば 
雪 降 れ ば 冬 ご も り せ る 草 も 木 も 	春 に 知 ら れ ぬ 花 ぞ 咲 き け る 
白 雪 の と こ ろ も わ か ず 降 り し け ば 	巌 に も 咲 く 花 と こ そ 見 れ 
み 吉 野 の 山 の 白 雪 つ も る ら し 	ふ る さ と 寒 く な り ま さ る な り 
浦 近 く 降 り く る 雪 は 白 浪 の 	末 の 松 山 越 す か と ぞ 見 る 
み 吉 野 の 山 の 白 雪 踏 み わ け て 	入 り に し 人 の お と づ れ も せ ぬ 
白 雪 の 降 り て つ も れ る 山 里 は 	住 む 人 さ へ や 思 ひ 消 ゆ ら む 
雪 降 り て 人 も か よ は ぬ 道 な れ や 	あ と は か も な く 思 ひ 消 ゆ ら む 
冬 な が ら 空 よ り 花 の 散 り く る は 	雲 の あ な た は 春 に や あ る ら む 
冬 ご も り 思 ひ か け ぬ を 木 の 間 よ り 	花 と 見 る ま で 雪 ぞ 降 り け る 
朝 ぼ ら け 有 明 の 月 と 見 る ま で に 	吉 野 の 里 に 降 れ る 白 雪 
消 ぬ が う へ に ま た も 降 り し け 春 霞 	立 ち な ば み 雪 ま れ に こ そ 見 め 
梅 の 花 そ れ と も 見 え ず 久 方 の 	あ ま ぎ る 雪 の な べ て 降 れ れ ば 
花 の 色 は 雪 に ま じ り て 見 え ず と も 	香 を だ に 匂 へ 人 の 知 る べ く 
梅 の 香 の 降 り お け る 雪 に ま が ひ せ ば 	誰 か こ と ご と わ き て 折 ら ま し 
雪 降 れ ば 木 ご と に 花 ぞ 咲 き に け る 	い づ れ を 梅 と わ き て 折 ら ま し 
我 が 待 た ぬ 年 は き ぬ れ ど 冬 草 の 	枯 れ に し 人 は お と づ れ も せ ず 
あ ら た ま の 年 の 終 り に な る ご と に 	雪 も 我 が 身 も ふ り ま さ り つ つ 
雪 降 り て 年 の 暮 れ ぬ る 時 に こ そ 	つ ひ に も み ぢ ぬ 松 も 見 え け れ 
昨 日 と 言 ひ 今 日 と く ら し て 明 日 香 河 	流 れ て 早 き 月 日 な り け り 
ゆ く 年 の 惜 し く も あ る か な ま す 鏡 	見 る 影 さ へ に く れ ぬ と 思 へ ば 
我 が 君 は 千 代 に 八 千 代 に さ ざ れ 石 の 	巌 と な り て 苔 の む す ま で 
わ た つ み の 浜 の 真 砂 を か ぞ へ つ つ 	君 が 千 歳 の あ り 数 に せ む 
し ほ の 山 さ し で の 磯 に 住 む 千 鳥 	君 が 御 代 を ば 八 千 代 と ぞ 鳴 く 
我 が よ は ひ 君 が 八 千 代 に と り そ へ て 	と ど め お き て は 思 ひ 出 で に せ よ 
か く し つ つ と に も か く に も な が ら へ て 	君 が 八 千 代 に あ ふ よ し も が な 
ち は や ぶ る 神 や 切 り け む つ く か ら に 	千 歳 の 坂 も 越 え ぬ べ ら な り 
桜 花 散 り か ひ く も れ 老 い ら く の 	来 む と 言 ふ な る 道 ま が ふ が に 
亀 の 尾 の 山 の 岩 根 を と め て お つ る 	滝 の 白 玉 千 代 の 数 か も 
い た づ ら に す ぐ す 月 日 は 思 ほ え で 	花 見 て く ら す 春 ぞ 少 な き 
春 く れ ば 宿 に ま づ 咲 く 梅 の 花 	君 が 千 歳 の か ざ し と ぞ 見 る 
い に し へ に あ り き あ ら ず は 知 ら ね ど も 	千 歳 の た め し 君 に は じ め む 
ふ し て 思 ひ お き て 数 ふ る 万 代 は 	神 ぞ 知 る ら む 我 が 君 の た め 
鶴 亀 も 千 歳 の 後 は 知 ら な く に 	あ か ぬ 心 に ま か せ は て て む 
万 代 を 松 に ぞ 君 を 祝 ひ つ る 	千 歳 の か げ に 住 ま む と 思 へ ば 
春 日 野 に 若 菜 つ み つ つ 万 代 を 	祝 ふ 心 は 神 ぞ 知 る ら む 
山 高 み 雲 ゐ に 見 ゆ る 桜 花 	心 の ゆ き て 折 ら ぬ 日 ぞ な き 
め づ ら し き 声 な ら な く に 郭 公 	こ こ ら の 年 を あ か ず も あ る か な 
住 の 江 の 松 を 秋 風 吹 く か ら に 	声 う ち そ ふ る 沖 つ 白 浪 
千 鳥 鳴 く 佐 保 の 河 霧 立 ち ぬ ら し 	山 の 木 の 葉 も 色 ま さ り ゆ く 
秋 く れ ど 色 も か は ら ぬ と き は 山 	よ そ の も み ぢ を 風 ぞ か し け る 
白 雪 の 降 り し く 時 は み 吉 野 の 	山 下 風 に 花 ぞ 散 り け る 
峰 高 き 春 日 の 山 に い づ る 日 は 	曇 る 時 な く 照 ら す べ ら な り 
立 ち 別 れ い な ば の 山 の 峰 に お ふ る 	松 と し 聞 か ば 今 か へ り こ む 
す が る な く 秋 の 萩 原 朝 た ち て 	旅 行 く 人 を い つ と か 待 た む 
か ぎ り な き 雲 ゐ の よ そ に わ か る と も 	人 を 心 に お く ら さ む や は 
た ら ち ね の 親 の ま も り と あ ひ そ ふ る 	心 ば か り は せ き な と ど め そ 
今 日 別 れ 明 日 は あ ふ み と 思 へ ど も 	夜 や ふ け ぬ ら む 袖 の 露 け き 
か へ る 山 あ り と は 聞 け ど 春 霞 	立 ち 別 れ な ば 恋 し か る べ し 
惜 し む か ら 恋 し き も の を 白 雲 の 	た ち な む の ち は な に 心 地 せ む 
別 れ て は ほ ど を へ だ つ と 思 へ ば や 	か つ 見 な が ら に か ね て 恋 し き 
思 へ ど も 身 を し わ け ね ば 目 に 見 え ぬ 	心 を 君 に た ぐ へ て ぞ や る 
あ ふ 坂 の 関 し ま さ し き も の な ら ば 	あ か ず 別 る る 君 を と ど め よ 
唐 衣 た つ 日 は 聞 か じ 朝 露 の 	置 き て し ゆ け ば け ぬ べ き も の を 
朝 な げ に 見 べ き 君 と し た の ま ね ば 	思 ひ た ち ぬ る 草 枕 な り 
え ぞ 知 ら ぬ 今 こ こ ろ み よ 命 あ ら ば 	我 や 忘 る る 人 や と は ぬ と 
雲 ゐ に も か よ ふ 心 の お く れ ね ば 	わ か る と 人 に 見 ゆ ば か り な り 
白 雲 の こ な た か な た に 立 ち 別 れ 	心 を ぬ さ と く だ く 旅 か な 
白 雲 の 八 重 に か さ な る を ち に て も 	思 は む 人 に 心 へ だ つ な 
別 れ て ふ こ と は 色 に も あ ら な く に 	心 に し み て わ び し か る ら む 
か へ る 山 な に ぞ は あ り て あ る か ひ は 	き て も と ま ら ぬ 名 に こ そ あ り け れ 
よ そ に の み 恋 ひ や 渡 ら む 白 山 の 	雪 見 る べ く も あ ら ぬ 我 が 身 は 
音 羽 山 こ だ か く 鳴 き て 郭 公 	君 が 別 れ を 惜 し む べ ら な り 
も ろ と も に な き て と ど め よ き り ぎ り す 	秋 の 別 れ は 惜 し く や は あ ら ぬ 
秋 霧 の 共 に 立 ち い で て 別 れ な ば 	は れ ぬ 思 ひ に 恋 や わ た ら む 
命 だ に 心 に か な ふ も の な ら ば 	な に か 別 れ の か な し か ら ま し 
人 や り の 道 な ら な く に お ほ か た は 	い き 憂 し と い ひ て い ざ 帰 り な む 
し た は れ て き に し 心 の 身 に し あ れ ば 	帰 る さ ま に は 道 も 知 ら れ ず 
か つ 越 え て 別 れ も ゆ く か あ ふ 坂 は 	人 だ の め な る 名 に こ そ あ り け れ 
君 が ゆ く 越 の 白 山 知 ら ね ど も 	雪 の ま に ま に あ と は た づ ね む 
夕 暮 れ の ま が き は 山 と 見 え な な む 	夜 は 越 え じ と 宿 り と る べ く 
別 れ を ば 山 の 桜 に ま か せ て む 	と め む と め じ は 花 の ま に ま に 
山 風 に 桜 吹 き ま き 乱 れ な む 	花 の ま ぎ れ に 君 と ま る べ く 
こ と な ら ば 君 と ま る べ く 匂 は な む 	か へ す は 花 の う き に や は あ ら ぬ 
あ か ず し て 別 る る 涙 滝 に そ ふ 	水 ま さ る と や し も は 見 る ら む 
秋 萩 の 花 を ば 雨 に 濡 ら せ ど も 	君 を ば ま し て 惜 し と こ そ 思 へ 
惜 し む ら む 人 の 心 を 知 ら ぬ ま に 	秋 の 時 雨 と 身 ぞ ふ り に け る 
別 る れ ど う れ し く も あ る か 今 宵 よ り 	あ ひ 見 ぬ 先 に 何 を 恋 ひ ま し 
あ か ず し て 別 る る 袖 の 白 玉 を 	君 が 形 見 と つ つ み て ぞ 行 く 
か ぎ り な く 思 ふ 涙 に そ ほ ち ぬ る 	袖 は か わ か じ あ は む 日 ま で に 
か き く ら し こ と は ふ ら な む 春 雨 に 	濡 衣 き せ て 君 を と ど め む 
し ひ て 行 く 人 を と ど め む 桜 花 	い づ れ を 道 と 惑 ふ ま で 散 れ 
む す ぶ 手 の し づ く に 濁 る 山 の 井 の 	あ か で も 人 に 別 れ ぬ る か な 
下 の 帯 の 道 は か た が た 別 る と も 	行 き め ぐ り て も あ は む と ぞ 思 ふ 
天 の 原 ふ り さ け 見 れ ば 春 日 な る 	三 笠 の 山 に い で し 月 か も 
わ た の 原 八 十 島 か け て こ ぎ い で ぬ と 	人 に は 告 げ よ 海 人 の 釣 り 舟 
み や こ い で て け ふ み か の 原 い づ み 川 	川 風 寒 し 衣 か せ 山 
ほ の ぼ の と 明 石 の 浦 の 朝 霧 に 	島 隠 れ 行 く 舟 を し ぞ 思 ふ 
唐 衣 き つ つ な れ に し つ ま し あ れ ば 	は る ば る き ぬ る 旅 を し ぞ 思 ふ 
名 に し お は ば い ざ 言 問 は む み や こ 鳥 	我 が 思 ふ 人 は あ り や な し や と 
北 へ 行 く 雁 ぞ 鳴 く な る つ れ て こ し 	数 は た ら で ぞ か へ る べ ら な る 
山 か く す 春 の 霞 ぞ う ら め し き 	い づ れ み や こ の さ か ひ な る ら む 
消 え は つ る 時 し な け れ ば 越 路 な る 	白 山 の 名 は 雪 に ぞ あ り け る 
糸 に よ る も の な ら な く に 別 れ ぢ の 	心 細 く も 思 ほ ゆ る か な 
夜 を 寒 み 置 く 初 霜 を は ら ひ つ つ 	草 の 枕 に あ ま た 旅 寝 ぬ 
夕 月 夜 お ぼ つ か な き を 玉 く し げ 	ふ た み の う ら は あ け て こ そ 見 め 
か り く ら し 七 夕 つ め に 宿 か ら む 	天 の 河 原 に 我 は き に け り 
ひ と と せ に ひ と た び き ま す 君 ま て ば 	宿 か す 人 も あ ら じ と ぞ 思 ふ 
こ の た び は ぬ さ も と り あ へ ず た む け 山 	紅 葉 の 錦 神 の ま に ま に 
た む け に は つ づ り の 袖 も 切 る べ き に 	紅 葉 に あ け る 神 や か へ さ む 
心 か ら 花 の し づ く に そ ほ ち つ つ 	う く ひ す と の み 鳥 の 鳴 く ら む 
く べ き ほ ど 時 す ぎ ぬ れ や 待 ち わ び て 	鳴 く な る 声 の 人 を と よ む る 
浪 の 打 つ 瀬 見 れ ば 玉 ぞ 乱 れ け る 	拾 は ば 袖 に は か な か ら む や 
袂 よ り は な れ て 玉 を つ つ ま め や 	こ れ な む そ れ と う つ せ 見 む か し 
あ な う め に つ ね な る べ く も 見 え ぬ か な 	恋 し か る べ き 香 は 匂 ひ つ つ 
か づ け ど も 浪 の な か に は さ ぐ ら れ で 	風 吹 く ご と に 浮 き 沈 む 玉 
今 い く か 春 し な け れ ば う ぐ ひ す も 	も の は な が め て 思 ふ べ ら な り 
あ ふ か ら も も の は な ほ こ そ か な し け れ 	別 れ む こ と を か ね て 思 へ ば 
あ し ひ き の 山 た ち は な れ 行 く 雲 の 	宿 り さ だ め ぬ 世 に こ そ あ り け れ 
み 吉 野 の 吉 野 の 滝 に 浮 か び い づ る 	泡 を か た ま の 消 ゆ と 見 つ ら む 
秋 は き ぬ い ま や ま が き の き り ぎ り す 	夜 な 夜 な 鳴 か む 風 の 寒 さ に 
か く ば か り あ ふ 日 の ま れ に な る 人 を 	い か が つ ら し と 思 は ざ る べ き 
人 目 ゆ ゑ の ち に あ ふ 日 の は る け く は 	我 が つ ら き に や 思 ひ な さ れ む 
散 り ぬ れ ば の ち は あ く た に な る 花 を 	思 ひ 知 ら ず も 惑 ふ て ふ か な 
我 は け さ う ひ に ぞ 見 つ る 花 の 色 を 	あ だ な る も の と 言 ふ べ か り け り 
白 露 を 玉 に ぬ く と や さ さ が に の 	花 に も 葉 に も い と を み な へ し 
朝 露 を わ け そ ほ ち つ つ 花 見 む と 	今 ぞ 野 山 を み な へ し り ぬ る 
を ぐ ら 山 峰 た ち な ら し 鳴 く 鹿 の 	へ に け む 秋 を 知 る 人 ぞ な き 
秋 ち か う 野 は な り に け り 白 露 の 	お け る 草 葉 も 色 か は り ゆ く 
ふ り は へ て い ざ ふ る さ と の 花 見 む と 	こ し を 匂 ひ ぞ う つ ろ ひ に け る 
我 が 宿 の 花 ふ み し だ く と り う た む 	野 は な け れ ば や こ こ に し も く る 
あ り と 見 て た の む ぞ か た き 空 蝉 の 	世 を ば な し と や 思 ひ な し て む 
う ち つ け に こ し と や 花 の 色 を 見 む 	置 く 白 露 の 染 む る ば か り を 
花 の 木 に あ ら ざ ら め ど も 咲 き に け り 	ふ り に し こ の 身 な る 時 も が な 
山 高 み つ ね に 嵐 の 吹 く 里 は 	匂 ひ も あ へ ず 花 ぞ 散 り け る 
郭 公 峰 の 雲 に や ま じ り に し 	あ り と は 聞 け ど 見 る よ し も な き 
空 蝉 の 殻 は 木 ご と に と ど む れ ど 	魂 の ゆ く へ を 見 ぬ ぞ か な し き 
う ば た ま の 夢 に な に か は な ぐ さ ま む 	う つ つ に だ に も あ か ぬ 心 を 
花 の 色 は た だ ひ と さ か り 濃 け れ ど も 	返 す 返 す ぞ 露 は 染 め け る 
命 と て 露 を た の む に か た け れ ば 	も の わ び し ら に 鳴 く 野 辺 の 虫 
小 夜 ふ け て な か ば た け ゆ く 久 方 の 	月 吹 き か へ せ 秋 の 山 風 
煙 た ち も ゆ と も 見 え ぬ 草 の 葉 を 	誰 か わ ら び と 名 づ け そ め け む 
い さ さ め に 時 ま つ ま に ぞ 日 は へ ぬ る 	心 ば せ を ば 人 に 見 え つ つ 
あ ぢ き な し な げ き な つ め そ う き こ と に 	あ ひ く る 身 を ば 捨 て ぬ も の か ら 
浪 の 音 の 今 朝 か ら こ と に 聞 こ ゆ る は 	春 の し ら べ や あ ら た ま る ら む 
か ぢ に あ た る 浪 の し づ く を 春 な れ ば 	い か が 咲 き 散 る 花 と 見 ざ ら む 
か の 方 に い つ か ら 先 に わ た り け む 	浪 ぢ は あ と も 残 ら ざ り け り 
浪 の 花 沖 か ら 咲 き て 散 り く め り 	水 の 春 と は 風 や な る ら む 
う ば た ま の 我 が 黒 髪 や か は る ら む 	鏡 の か げ に 降 れ る 白 雪 
あ し ひ き の 山 辺 に を れ ば 白 雲 の 	い か に せ よ と か 晴 る る 時 な き 
夏 草 の 上 は し げ れ る 沼 水 の 	行 く 方 の な き 我 が 心 か な 
秋 く れ ば 月 の 桂 の 実 や は な る 	光 を 花 と 散 ら す ば か り を 
花 ご と に あ か ず 散 ら し し 風 な れ ば 	い く そ ば く 我 が 憂 し と か は 思 ふ 
春 霞 な か し か よ ひ ぢ な か り せ ば 	秋 く る 雁 は か へ ら ざ ら ま し 
流 れ い づ る 方 だ に 見 え ぬ 涙 川 	お き ひ む 時 や 底 は 知 ら れ む 
の ち ま き の お く れ て お ふ る 苗 な れ ど 	あ だ に は な ら ぬ た の み と ぞ 聞 く 
花 の 中 目 に あ く や と て わ け ゆ け ば 	心 ぞ と も に 散 り ぬ べ ら な る 
郭 公 鳴 く や 五 月 の あ や め 草 	あ や め も 知 ら ぬ 恋 も す る か な 
音 に の み き く の 白 露 夜 は お き て 	昼 は 思 ひ に あ へ ず け ぬ べ し 
吉 野 川 岩 波 高 く 行 く 水 の 	早 く ぞ 人 を 思 ひ そ め て し 
白 浪 の あ と な き 方 に 行 く 舟 も 	風 ぞ た よ り の し る べ な り け る 
音 羽 山 音 に 聞 き つ つ あ ふ 坂 の 	関 の こ な た に 年 を ふ る か な 
立 ち 返 り あ は れ と ぞ 思 ふ よ そ に て も 	人 に 心 を 沖 つ 白 浪 
世 の 中 は か く こ そ あ り け れ 吹 く 風 の 	目 に 見 ぬ 人 も 恋 し か り け り 
見 ず も あ ら ず 見 も せ ぬ 人 の 恋 し く は 	あ や な く 今 日 や な が め く ら さ む 
知 る 知 ら ぬ な に か あ や な く わ き て 言 は む 	思 ひ の み こ そ し る べ な り け れ 
春 日 野 の 雪 間 を わ け て お ひ い で く る 	草 の は つ か に 見 え し 君 は も 
山 桜 霞 の 間 よ り ほ の か に も 	見 て し 人 こ そ 恋 し か り け れ 
た よ り に も あ ら ぬ 思 ひ の あ や し き は 	心 を 人 に つ く る な り け り 
初 雁 の は つ か に 声 を 聞 き し よ り 	中 空 に の み 物 を 思 ふ か な 
あ ふ こ と は 雲 ゐ は る か に な る 神 の 	音 に 聞 き つ つ 恋 ひ 渡 る か な 
片 糸 を こ な た か な た に よ り か け て 	あ は ず は な に を 玉 の 緒 に せ む 
夕 暮 れ は 雲 の は た て に 物 ぞ 思 ふ 	天 つ 空 な る 人 を 恋 ふ と て 
か り こ も の 思 ひ 乱 れ て 我 が 恋 ふ と 	妹 知 る ら め や 人 し つ げ ず は 
つ れ も な き 人 を や ね た く 白 露 の 	置 く と は な げ き 寝 と は し の ば む 
ち は や ぶ る 賀 茂 の や し ろ の ゆ ふ だ す き 	ひ と 日 も 君 を か け ぬ 日 は な し 
我 が 恋 は む な し き 空 に 満 ち ぬ ら し 	思 ひ や れ ど も 行 く 方 も な し 
駿 河 な る 田 子 の 浦 浪 立 た ぬ 日 は 	あ れ ど も 君 を 恋 ひ ぬ 日 ぞ な き 
夕 月 夜 さ す や を か べ の 松 の 葉 の 	い つ と も わ か ぬ 恋 も す る か な 
あ し ひ き の 山 下 水 の 木 隠 れ て 	た ぎ つ 心 を せ き ぞ か ね つ る 
吉 野 川 岩 切 り と ほ し 行 く 水 の 	音 に は た て じ 恋 は 死 ぬ と も 
た ぎ つ 瀬 の な か に も 淀 は あ り て ふ を 	な ど 我 が 恋 の 淵 瀬 と も な き 
山 高 み 下 ゆ く 水 の 下 に の み 	流 れ て 恋 ひ む 恋 は 死 ぬ と も 
思 ひ い づ る と き は の 山 の 岩 つ つ じ 	言 は ね ば こ そ あ れ 恋 し き も の を 
人 知 れ ず 思 へ ば 苦 し 紅 の 	末 摘 花 の 色 に い で な む 
秋 の 野 の 尾 花 に ま じ り 咲 く 花 の 	色 に や 恋 ひ む あ ふ よ し を な み 
我 が 園 の 梅 の ほ つ え に う ぐ ひ す の 	音 に 鳴 き ぬ べ き 恋 も す る か な 
あ し ひ き の 山 郭 公 我 が ご と や 	君 に 恋 ひ つ つ い ね が て に す る 
夏 な れ ば 宿 に ふ す ぶ る か や り 火 の 	い つ ま で 我 が 身 下 も え を せ む 
恋 せ じ と み た ら し 川 に せ し み そ ぎ 	神 は う け ず ぞ な り に け ら し も 
あ は れ て ふ こ と だ に な く は な に を か は 	恋 の 乱 れ の つ か ね を に せ む 
思 ふ に は 忍 ぶ る こ と ぞ 負 け に け る 	色 に は い で じ と 思 ひ し も の を 
我 が 恋 を 人 知 る ら め や し き た へ の 	枕 の み こ そ 知 ら ば 知 る ら め 
あ さ ぢ ふ の 小 野 の し の 原 し の ぶ と も 	人 知 る ら め や 言 ふ 人 な し に 
人 知 れ ぬ 思 ひ や な ぞ と 葦 垣 の 	ま ぢ か け れ ど も あ ふ よ し の な き 
思 ふ と も 恋 ふ と も あ は む も の な れ や 	ゆ ふ て も た ゆ く と く る 下 紐 
い で 我 を 人 な と が め そ お ほ 舟 の 	ゆ た の た ゆ た に 物 思 ふ こ ろ ぞ 
伊 勢 の 海 に 釣 り す る 海 人 の う け な れ や 	心 ひ と つ を 定 め か ね つ る 
伊 勢 の 海 の 海 人 の 釣 り 縄 う ち は へ て 	く る し と の み や 思 ひ わ た ら む 
涙 川 な に 水 上 を 尋 ね け む 	物 思 ふ 時 の 我 が 身 な り け り 
種 し あ れ ば 岩 に も 松 は お ひ に け り 	恋 を し 恋 ひ ば あ は ざ ら め や は 
朝 な 朝 な 立 つ 河 霧 の 空 に の み 	う き て 思 ひ の あ る 世 な り け り 
忘 ら る る 時 し な け れ ば あ し た づ の 	思 ひ 乱 れ て 音 を の み ぞ 鳴 く 
唐 衣 日 も 夕 暮 れ に な る 時 は 	返 す 返 す ぞ 人 は 恋 し き 
よ ひ よ ひ に 枕 さ だ め む 方 も な し 	い か に 寝 し 夜 か 夢 に 見 え け む 
恋 し き に 命 を か ふ る も の な ら ば 	死 に は や す く ぞ あ る べ か り け る 
人 の 身 も な ら は し も の を あ は ず し て 	い ざ こ こ ろ み む 恋 ひ や 死 ぬ る と 
忍 ぶ れ ば 苦 し き も の を 人 知 れ ず 	思 ふ て ふ こ と 誰 に か た ら む 
こ む 世 に も は や な り な な む 目 の 前 に 	つ れ な き 人 を 昔 と 思 は む 
つ れ も な き 人 を 恋 ふ と て 山 彦 の 	答 へ す る ま で な げ き つ る か な 
行 く 水 に 数 か く よ り も は か な き は 	思 は ぬ 人 を 思 ふ な り け り 
人 を 思 ふ 心 は 我 に あ ら ね ば や 	身 の 惑 ふ だ に 知 ら れ ざ る ら む 
思 ひ や る さ か ひ は る か に な り や す る 	惑 ふ 夢 ぢ に あ ふ 人 の な き 
夢 の 内 に あ ひ 見 む こ と を た の み つ つ 	く ら せ る 宵 は 寝 む 方 も な し 
恋 ひ 死 ね と す る わ ざ な ら し む ば た ま の 	夜 は す が ら に 夢 に 見 え つ つ 
涙 川 枕 流 る る う き ね に は 	夢 も さ だ か に 見 え ず ぞ あ り け る 
恋 す れ ば 我 が 身 は 影 と な り に け り 	さ り と て 人 に そ は ぬ も の ゆ ゑ 
か が り 火 に あ ら ぬ 我 が 身 の な ぞ も か く 	涙 の 川 に 浮 き て も ゆ ら む 
か が り 火 の 影 と な る 身 の わ び し き は 	な が れ て 下 に も ゆ る な り け り 
は や き 瀬 に み る め お ひ せ ば 我 が 袖 の 	涙 の 川 に 植 ゑ ま し も の を 
沖 へ に も よ ら ぬ 玉 藻 の 浪 の 上 に 	乱 れ て の み や 恋 ひ 渡 り な む 
葦 鴨 の 騒 ぐ 入 江 の 白 浪 の 	知 ら ず や 人 を か く 恋 ひ む と は 
人 知 れ ぬ 思 ひ を つ ね に す る が な る 	富 士 の 山 こ そ 我 が 身 な り け れ 
と ぶ 鳥 の 声 も 聞 こ え ぬ 奥 山 の 	深 き 心 を 人 は 知 ら な む 
あ ふ 坂 の ゆ ふ つ け 鳥 も 我 が ご と く 	人 や 恋 し き 音 の み 鳴 く ら む 
あ ふ 坂 の 関 に 流 る る 岩 清 水 	言 は で 心 に 思 ひ こ そ す れ 
浮 草 の 上 は し げ れ る 淵 な れ や 	深 き 心 を 知 る 人 の な き 
う ち わ び て よ ば は む 声 に 山 彦 の 	答 へ ぬ 山 は あ ら じ と ぞ 思 ふ 
心 が へ す る も の に も が 片 恋 は 	苦 し き も の と 人 に 知 ら せ む 
よ そ に し て 恋 ふ れ ば 苦 し 入 れ 紐 の 	同 じ 心 に い ざ 結 び て む 
春 た て ば 消 ゆ る 氷 の 残 り な く 	君 が 心 は 我 に と け な む 
明 け た て ば 蝉 の を り は へ な き く ら し 	夜 は 蛍 の も え こ そ わ た れ 
夏 虫 の 身 を い た づ ら に な す こ と も 	ひ と つ 思 ひ に よ り て な り け り 
夕 さ れ ば い と ど ひ が た き 我 が 袖 に 	秋 の 露 さ へ 置 き そ は り つ つ 
い つ と て も 恋 し か ら ず は あ ら ね ど も 	秋 の 夕 べ は あ や し か り け り 
秋 の 田 の 穂 に こ そ 人 を 恋 ひ ざ ら め 	な ど か 心 に 忘 れ し も せ む 
秋 の 田 の 穂 の 上 を 照 ら す 稲 妻 の 	光 の 間 に も 我 や 忘 る る 
人 目 も る 我 か は あ や な 花 薄 	な ど か 穂 に い で て 恋 ひ ず し も あ ら む 
淡 雪 の た ま れ ば か て に く だ け つ つ 	我 が 物 思 ひ の し げ き こ ろ か な 
奥 山 の 菅 の 根 し の ぎ 降 る 雪 の 	け ぬ と か 言 は む 恋 の し げ き に 
思 ひ つ つ 寝 れ ば や 人 の 見 え つ ら む 	夢 と 知 り せ ば 覚 め ざ ら ま し を 
う た た ね に 恋 し き 人 を 見 て し よ り 	夢 て ふ も の は た の み そ め て き 
い と せ め て 恋 し き 時 は む ば た ま の 	夜 の 衣 を 返 し て ぞ き る 
秋 風 の 身 に 寒 け れ ば つ れ も な き 	人 を ぞ た の む 暮 る る 夜 ご と に 
つ つ め ど も 袖 に た ま ら ぬ 白 玉 は 	人 を 見 ぬ 目 の 涙 な り け り 
お ろ か な る 涙 ぞ 袖 に 玉 は な す 	我 は せ き あ へ ず た ぎ つ 瀬 な れ ば 
恋 わ び て う ち ぬ る な か に 行 き か よ ふ 	夢 の た だ ぢ は う つ つ な ら な む 
住 の 江 の 岸 に よ る 浪 よ る さ へ や 	夢 の か よ ひ ぢ 人 目 よ ぐ ら む 
我 が 恋 は み 山 隠 れ の 草 な れ や 	し げ さ ま さ れ ど 知 る 人 の な き 
宵 の 間 も は か な く 見 ゆ る 夏 虫 に 	惑 ひ ま さ れ る 恋 も す る か な 
夕 さ れ ば 蛍 よ り け に も ゆ れ ど も 	光 見 ね ば や 人 の つ れ な き 
笹 の 葉 に 置 く 霜 よ り も ひ と り 寝 る 	我 が 衣 手 ぞ さ え ま さ り け る 
我 が 宿 の 菊 の 垣 根 に 置 く 霜 の 	消 え か へ り て ぞ 恋 し か り け る 
川 の 瀬 に な び く 玉 藻 の み 隠 れ て 	人 に 知 ら れ ぬ 恋 も す る か な 
か き く ら し 降 る 白 雪 の 下 ぎ え に 	消 え て 物 思 ふ こ ろ に も あ る か な 
君 恋 ふ る 涙 の 床 に 満 ち ぬ れ ば 	み を つ く し と ぞ 我 は な り ぬ る 
死 ぬ る 命 生 き も や す る と こ こ ろ み に 	玉 の 緒 ば か り あ は む と 言 は な む 
わ び ぬ れ ば し ひ て 忘 れ む と 思 へ ど も 	夢 と 言 ふ も の ぞ 人 だ の め な る 
わ り な く も 寝 て も 覚 め て も 恋 し き か 	心 を い づ ち や ら ば 忘 れ む 
恋 し き に わ び て た ま し ひ 惑 ひ な ば 	む な し き 殻 の 名 に や 残 ら む 
君 恋 ふ る 涙 し な く は 唐 衣 	胸 の あ た り は 色 も え な ま し 
世 と と も に 流 れ て ぞ 行 く 涙 川 	冬 も こ ほ ら ぬ み な わ な り け り 
夢 ぢ に も 露 や 置 く ら む 夜 も す が ら 	か よ へ る 袖 の ひ ち て か わ か ぬ 
は か な く て 夢 に も 人 を 見 つ る 夜 は 	あ し た の 床 ぞ 起 き う か り け る 
い つ は り の 涙 な り せ ば 唐 衣 	し の び に 袖 は し ぼ ら ざ ら ま し 
ね に な き て ひ ち に し か ど も 春 雨 に 	濡 れ に し 袖 と と は ば 答 へ む 
我 が ご と く も の や か な し き 郭 公 	時 ぞ と も な く 夜 た だ 鳴 く ら む 
五 月 山 梢 を 高 み 郭 公 	鳴 く 音 空 な る 恋 も す る か な 
秋 霧 の 晴 る る 時 な き 心 に は 	た ち ゐ の 空 も 思 ほ え な く に 
虫 の ご と 声 に た て て は な か ね ど も 	涙 の み こ そ 下 に 流 る れ 
秋 な れ ば 山 と よ む ま で 鳴 く 鹿 に 	我 お と ら め や ひ と り 寝 る 夜 は 
秋 の 野 に 乱 れ て 咲 け る 花 の 色 の 	ち ぐ さ に 物 を 思 ふ こ ろ か な 
ひ と り し て 物 を 思 へ ば 秋 の 夜 の 	稲 葉 の そ よ と 言 ふ 人 の な き 
人 を 思 ふ 心 は 雁 に あ ら ね ど も 	雲 ゐ に の み も な き 渡 る か な 
秋 風 に か き な す 琴 の 声 に さ へ 	は か な く 人 の 恋 し か る ら む 
ま こ も 刈 る 淀 の 沢 水 雨 降 れ ば 	常 よ り こ と に ま さ る 我 が 恋 
越 え ぬ 間 は 吉 野 の 山 の 桜 花 	人 づ て に の み 聞 き 渡 る か な 
露 な ら ぬ 心 を 花 に 置 き そ め て 	風 吹 く ご と に 物 思 ひ ぞ つ く 
我 が 恋 に く ら ぶ の 山 の 桜 花 	間 な く 散 る と も 数 は ま さ ら じ 
冬 川 の 上 は こ ほ れ る 我 な れ や 	下 に 流 れ て 恋 ひ 渡 る ら む 
た ぎ つ 瀬 に 根 ざ し と ど め ぬ 浮 草 の 	浮 き た る 恋 も 我 は す る か な 
よ ひ よ ひ に 脱 ぎ て 我 が 寝 る か り 衣 	か け て 思 は ぬ 時 の 間 も な し 
東 ぢ の 小 夜 の 中 山 な か な か に 	な に し か 人 を 思 ひ そ め け む 
し き た へ の 枕 の 下 に 海 は あ れ ど 	人 を み る め は お ひ ず ぞ あ り け る 
年 を へ て 消 え ぬ 思 ひ は あ り な が ら 	夜 の 袂 は な ほ こ ほ り け り 
我 が 恋 は 知 ら ぬ 山 ぢ に あ ら な く に 	惑 ふ 心 ぞ わ び し か り け る 
紅 の ふ り い で つ つ な く 涙 に は 	袂 の み こ そ 色 ま さ り け れ 
白 玉 と 見 え し 涙 も 年 ふ れ ば 	唐 紅 に う つ ろ ひ に け り 
夏 虫 を 何 か 言 ひ け む 心 か ら 	我 も 思 ひ に も え ぬ べ ら な り 
風 吹 け ば 峰 に わ か る る 白 雲 の 	絶 え て つ れ な き 君 が 心 か 
月 影 に 我 が 身 を か ふ る も の な ら ば 	つ れ な き 人 も あ は れ と や 見 む 
恋 ひ 死 な ば た が 名 は た た じ 世 の 中 の 	常 な き も の と 言 ひ は な す と も 
津 の 国 の 難 波 の 葦 の 芽 も は る に 	し げ き 我 が 恋 人 知 る ら め や 
手 も ふ れ で 月 日 へ に け る 白 真 弓 	お き ふ し 夜 は い こ そ 寝 ら れ ね 
人 知 れ ぬ 思 ひ の み こ そ わ び し け れ 	我 が な げ き を ば 我 の み ぞ 知 る 
こ と に い で て 言 は ぬ ば か り ぞ み な せ 川 	下 に か よ ひ て 恋 し き も の を 
君 を の み 思 ひ ね に 寝 し 夢 な れ ば 	我 が 心 か ら 見 つ る な り け り 
命 に も ま さ り て 惜 し く あ る も の は 	見 は て ぬ 夢 の さ む る な り け り 
梓 弓 ひ け ば 本 末 我 が 方 に 	よ る こ そ ま さ れ 恋 の 心 は 
我 が 恋 は ゆ く へ も 知 ら ず は て も な し 	あ ふ を か ぎ り と 思 ふ ば か り ぞ 
我 の み ぞ か な し か り け る 彦 星 も 	あ は で す ぐ せ る 年 し な け れ ば 
今 は は や 恋 ひ 死 な ま し を あ ひ 見 む と 	た の め し こ と ぞ 命 な り け る 
た の め つ つ あ は で 年 ふ る い つ は り に 	こ り ぬ 心 を 人 は 知 ら な む 
命 や は な に ぞ は 露 の あ だ も の を 	あ ふ に し か へ ば 惜 し か ら な く に 
起 き も せ ず 寝 も せ で 夜 を 明 か し て は 	春 の も の と て な が め く ら し つ 
つ れ づ れ の な が め に ま さ る 涙 川 	袖 の み 濡 れ て あ ふ よ し も な し 
浅 み こ そ 袖 は ひ つ ら め 涙 川 	身 さ へ 流 る と 聞 か ば た の ま む 
よ る べ な み 身 を こ そ 遠 く へ だ て つ れ 	心 は 君 が 影 と な り に き 
い た づ ら に 行 き て は き ぬ る も の ゆ ゑ に 	見 ま く ほ し さ に い ざ な は れ つ つ 
あ は ぬ 夜 の 降 る 白 雪 と つ も り な ば 	我 さ へ と も に け ぬ べ き も の を 
秋 の 野 に 笹 わ け し 朝 の 袖 よ り も 	あ は で こ し 夜 ぞ ひ ち ま さ り け る 
み る め な き 我 が 身 を 浦 と 知 ら ね ば や 	か れ な で 海 人 の 足 た ゆ く く る 
あ は ず し て 今 宵 明 け な ば 春 の 日 の 	長 く や 人 を つ ら し と 思 は む 
有 明 の つ れ な く 見 え し 別 れ よ り 	暁 ば か り 憂 き も の は な し 
あ ふ こ と の な ぎ さ に し よ る 浪 な れ ば 	う ら み て の み ぞ 立 ち 返 り け る 
か ね て よ り 風 に 先 立 つ 浪 な れ や 	あ ふ こ と な き に ま だ き 立 つ ら む 
陸 奥 に あ り と 言 ふ な る 名 取 川 	な き 名 と り て は く る し か り け り 
あ や な く て ま だ き な き 名 の 竜 田 川 	渡 ら で や ま む も の な ら な く に 
人 は い さ 我 は な き 名 の 惜 し け れ ば 	昔 も 今 も 知 ら ず と を 言 は む 
こ り ず ま に ま た も な き 名 は 立 ち ぬ べ し 	人 に く か ら ぬ 世 に し す ま へ ば 
人 知 れ ぬ 我 が か よ ひ ぢ の 関 守 は 	よ ひ よ ひ ご と に う ち も 寝 な な む 
し の ぶ れ ど 恋 し き 時 は あ し ひ き の 	山 よ り 月 の い で て こ そ く れ 
恋 ひ 恋 ひ て ま れ に 今 宵 ぞ あ ふ 坂 の 	ゆ ふ つ け 鳥 は 鳴 か ず も あ ら な む 
秋 の 夜 も 名 の み な り け り あ ふ と 言 へ ば 	こ と ぞ と も な く 明 け ぬ る も の を 
長 し と も 思 ひ ぞ は て ぬ 昔 よ り 	あ ふ 人 か ら の 秋 の 夜 な れ ば 
し の の め の ほ が ら ほ が ら と 明 け ゆ け ば 	お の が き ぬ ぎ ぬ な る ぞ か な し き 
明 け ぬ と て い ま は の 心 つ く か ら に 	な ど 言 ひ 知 ら ぬ 思 ひ そ ふ ら む 
明 け ぬ と て か へ る 道 に は こ き た れ て 	雨 も 涙 も 降 り そ ほ ち つ つ 
し の の め の 別 れ を 惜 し み 我 ぞ ま づ 	鳥 よ り 先 に な き は じ め つ る 
郭 公 夢 か う つ つ か 朝 露 の 	お き て 別 れ し 暁 の 声 
玉 く し げ あ け ば 君 が 名 立 ち ぬ べ み 	夜 深 く こ し を 人 見 け む か も 
今 朝 は し も お き け む 方 も 知 ら ざ り つ 	思 ひ い づ る ぞ 消 え て か な し き 
寝 ぬ る 夜 の 夢 を は か な み ま ど ろ め ば 	い や は か な に も な り ま さ る か な 
君 や こ し 我 や 行 き け む 思 ほ え ず 	夢 か う つ つ か 寝 て か さ め て か 
か き く ら す 心 の 闇 に 惑 ひ に き 	夢 う つ つ と は 世 人 さ だ め よ 
む ば た ま の 闇 の う つ つ は さ だ か な る 	夢 に い く ら も ま さ ら ざ り け り 
小 夜 ふ け て 天 の 門 渡 る 月 影 に 	あ か ず も 君 を あ ひ 見 つ る か な 
君 が 名 も 我 が 名 も 立 て じ 難 波 な る 	み つ と も 言 ふ な あ ひ き と も 言 は じ 
名 取 川 瀬 ぜ の む も れ 木 あ ら は れ ば 	い か に せ む と か あ ひ 見 そ め け む 
吉 野 川 水 の 心 は は や く と も 	滝 の 音 に は 立 て じ と ぞ 思 ふ 
恋 し く は し た に を 思 へ 紫 の 	ね ず り の 衣 色 に い づ な ゆ め 
花 薄 穂 に い で て 恋 ひ ば 名 を 惜 し み 	下 ゆ ふ 紐 の む す ぼ ほ れ つ つ 
お も ふ ど ち ひ と り ひ と り が 恋 ひ 死 な ば 	誰 に よ そ へ て 藤 衣 着 む 
泣 き 恋 ふ る 涙 に 袖 の そ ほ ち な ば 	脱 ぎ か へ が て ら 夜 こ そ は き め 
う つ つ に は さ も こ そ あ ら め 夢 に さ へ 	人 目 を も る と 見 る が わ び し さ 
か ぎ り な き 思 ひ の ま ま に 夜 も 来 む 	夢 ぢ を さ へ に 人 は と が め じ 
夢 ぢ に は 足 も 休 め ず か よ へ ど も 	う つ つ に ひ と 目 見 し ご と は あ ら ず 
思 へ ど も 人 目 つ つ み の 高 け れ ば 	川 と 見 な が ら え こ そ 渡 ら ね 
た ぎ つ 瀬 の は や き 心 を 何 し か も 	人 目 つ つ み の せ き と ど む ら む 
紅 の 色 に は い で じ 隠 れ 沼 の 	下 に か よ ひ て 恋 は 死 ぬ と も 
冬 の 池 に す む に ほ 鳥 の つ れ も な く 	そ こ に か よ ふ と 人 に 知 ら す な 
笹 の 葉 に 置 く 初 霜 の 夜 を 寒 み 	し み は つ く と も 色 に い で め や 
山 し な の 音 羽 の 山 の 音 に だ に 	人 の 知 る べ く 我 が 恋 め か も 
み つ 潮 の 流 れ ひ る ま を あ ひ が た み 	み る め の う ら に よ る を こ そ 待 て 
白 川 の 知 ら ず と も い は じ 底 清 み 	流 れ て 世 よ に す ま む と 思 へ ば 
下 に の み 恋 ふ れ ば 苦 し 玉 の 緒 の 	絶 え て 乱 れ む 人 な と が め そ 
我 が 恋 を し の び か ね て は あ し ひ き の 	山 橘 の 色 に い で ぬ べ し 
お ほ か た は 我 が 名 も み な と こ ぎ い で な む 	世 を う み べ た に み る め す く な し 
枕 よ り ま た 知 る 人 も な き 恋 を 	涙 せ き あ へ ず も ら し つ る か な 
風 吹 け ば 浪 う つ 岸 の 松 な れ や 	ね に あ ら は れ て 泣 き ぬ べ ら な り 
池 に す む 名 を を し 鳥 の 水 を 浅 み 	か く る と す れ ど あ ら は れ に け り 
あ ふ こ と は 玉 の 緒 ば か り 名 の 立 つ は 	吉 野 の 川 の た ぎ つ 瀬 の ご と 
む ら 鳥 の 立 ち に し 我 が 名 い ま さ ら に 	こ と な し ぶ と も し る し あ ら め や 
君 に よ り 我 が 名 は 花 に 春 霞 	野 に も 山 に も 立 ち 満 ち に け り 
知 る と 言 へ ば 枕 だ に せ で 寝 し も の を 	塵 な ら ぬ 名 の 空 に 立 つ ら む 
陸 奥 の 安 積 の 沼 の 花 か つ み 	か つ 見 る 人 に 恋 ひ や 渡 ら む 
あ ひ 見 ず は 恋 し き こ と も な か ら ま し 	音 に ぞ 人 を 聞 く べ か り け る 
い そ の か み ふ る の な か 道 な か な か に 	見 ず は 恋 し と 思 は ま し や は 
君 と 言 へ ば 見 ま れ 見 ず ま れ 富 士 の 嶺 の 	め づ ら し げ な く も ゆ る 我 が 恋 
夢 に だ に 見 ゆ と は 見 え じ 朝 な 朝 な 	我 が 面 影 に は づ る 身 な れ ば 
石 間 ゆ く 水 の 白 浪 立 ち 返 り 	か く こ そ は 見 め あ か ず も あ る か な 
伊 勢 の 海 人 の 朝 な 夕 な に か づ く て ふ 	み る め に 人 を あ く よ し も が な 
春 霞 た な び く 山 の 桜 花 	見 れ ど も あ か ぬ 君 に も あ る か な 
心 を ぞ わ り な き も の と 思 ひ ぬ る 	見 る も の か ら や 恋 し か る べ き 
枯 れ は て む の ち を ば 知 ら で 夏 草 の 	深 く も 人 の 思 ほ ゆ る か な 
飛 鳥 川 淵 は 瀬 に な る 世 な り と も 	思 ひ そ め て む 人 は 忘 れ じ 
思 ふ て ふ 言 の 葉 の み や 秋 を へ て 	色 も か は ら ぬ も の に は あ る ら む 
さ む し ろ に 衣 か た し き 今 宵 も や 	我 を 待 つ ら む 宇 治 の 橋 姫 
君 や こ む 我 や ゆ か む の い さ よ ひ に 	真 木 の 板 戸 も さ さ ず 寝 に け り 
今 こ む と 言 ひ し ば か り に 長 月 の 	有 明 の 月 を 待 ち い で つ る か な 
月 夜 よ し 夜 よ し と 人 に つ げ や ら ば 	こ て ふ に に た り 待 た ず し も あ ら ず 
君 こ ず は ね や へ も い ら じ 濃 紫 	我 が も と ゆ ひ に 霜 は 置 く と も 
宮 城 野 の も と あ ら の 小 萩 露 を 重 み 	風 を 待 つ ご と 君 を こ そ 待 て 
あ な 恋 し 今 も 見 て し か 山 が つ の 	か き ほ に さ け る 大 和 撫 子 
津 の 国 の な に は 思 は ず 山 し ろ の 	と は に あ ひ 見 む こ と を の み こ そ 
敷 島 や 大 和 に は あ ら ぬ 唐 衣 	こ ろ も へ ず し て あ ふ よ し も が な 
恋 し と は た が 名 づ け け む こ と な ら む 	死 ぬ と ぞ た だ に 言 ふ べ か り け る 
み 吉 野 の 大 川 の べ の 藤 波 の 	な み に 思 は ば 我 が 恋 め や は 
か く 恋 ひ む も の と は 我 も 思 ひ に き 	心 の う ら ぞ ま さ し か り け る 
天 の 原 ふ み と ど ろ か し な る 神 も 	思 ふ な か を ば さ く る も の か は 
梓 弓 ひ き 野 の つ づ ら 末 つ ひ に 	我 が 思 ふ 人 に こ と の し げ け む 
夏 引 き の 手 引 き の 糸 を く り か へ し 	こ と し げ く と も 絶 え む と 思 ふ な 
里 人 の こ と は 夏 野 の し げ く と も 	枯 れ 行 く 君 に あ は ざ ら め や は 
か ず か ず に 思 ひ 思 は ず と ひ が た み 	身 を 知 る 雨 は 降 り ぞ ま さ れ る 
お ほ ぬ さ の ひ く て あ ま た に な り ぬ れ ば 	思 へ ど え こ そ た の ま ざ り け れ 
お ほ ぬ さ と 名 に こ そ た て れ 流 れ て も 	つ ひ に よ る 瀬 は あ り て ふ も の を 
須 磨 の 海 人 の 塩 や く 煙 風 を い た み 	思 は ぬ 方 に た な び き に け り 
玉 か づ ら は ふ 木 あ ま た に な り ぬ れ ば 	絶 え ぬ 心 の う れ し げ も な し 
た が 里 に 夜 が れ を し て か 郭 公 	た だ こ こ に し も 寝 た る 声 す る 
い で 人 は こ と の み ぞ よ き 月 草 の 	う つ し 心 は 色 こ と に し て 
い つ は り の な き 世 な り せ ば い か ば か り 	人 の 言 の 葉 う れ し か ら ま し 
い つ は り と 思 ふ も の か ら 今 さ ら に 	た が ま こ と を か 我 は た の ま む 
秋 風 に 山 の 木 の 葉 の う つ ろ へ ば 	人 の 心 も い か が と ぞ 思 ふ 
蝉 の 声 聞 け ば か な し な 夏 衣 	薄 く や 人 の な ら む と 思 へ ば 
空 蝉 の 世 の 人 ご と の し げ け れ ば 	忘 れ ぬ も の の か れ ぬ べ ら な り 
あ か で こ そ 思 は む な か は 離 れ な め 	そ を だ に の ち の 忘 れ 形 見 に 
忘 れ な む と 思 ふ 心 の つ く か ら に 	あ り し よ り け に ま づ ぞ 恋 し き 
忘 れ な む 我 を う ら む な 郭 公 	人 の 秋 に は あ は む と も せ ず 
絶 え ず ゆ く 飛 鳥 の 川 の よ ど み な ば 	心 あ る と や 人 の 思 は む 
淀 川 の よ ど む と 人 は 見 る ら め ど 	流 れ て 深 き 心 あ る も の を 
そ こ ひ な き 淵 や は 騒 ぐ 山 川 の 	浅 き 瀬 に こ そ あ だ 浪 は た て 
紅 の 初 花 染 め の 色 深 く 	思 ひ し 心 我 忘 れ め や 
陸 奥 の し の ぶ も ぢ ず り 誰 ゆ ゑ に 	乱 れ む と 思 ふ 我 な ら な く に 
思 ふ よ り い か に せ よ と か 秋 風 に 	な び く あ さ ぢ の 色 こ と に な る 
ち ぢ の 色 に う つ ろ ふ ら め ど 知 ら な く に 	心 し 秋 の も み ぢ な ら ね ば 
海 人 の 住 む 里 の し る べ に あ ら な く に 	う ら み む と の み 人 の 言 ふ ら む 
曇 り 日 の 影 と し な れ る 我 な れ ば 	目 に こ そ 見 え ね 身 を ば 離 れ ず 
色 も な き 心 を 人 に 染 め し よ り 	う つ ろ は む と は 思 ほ え な く に 
め づ ら し き 人 を 見 む と や し か も せ ぬ 	我 が 下 紐 の と け 渡 る ら む 
か げ ろ ふ の そ れ か あ ら ぬ か 春 雨 の 	降 る 日 と な れ ば 袖 ぞ 濡 れ ぬ る 
堀 江 こ ぐ 棚 な し 小 舟 こ ぎ か へ り 	同 じ 人 に や 恋 ひ 渡 り な む 
わ た つ み と 荒 れ に し 床 を 今 さ ら に 	は ら は ば 袖 や 泡 と 浮 き な む 
い に し へ に な ほ 立 ち 返 る 心 か な 	恋 し き こ と に も の 忘 れ せ で 
思 ひ い で て 恋 し き 時 は 初 雁 の 	な き て 渡 る と 人 知 る ら め や 
た の め こ し 言 の 葉 今 は か へ し て む 	我 が 身 ふ る れ ば 置 き ど こ ろ な し 
今 は と て か へ す 言 の 葉 拾 ひ お き て 	お の が も の か ら 形 見 と や 見 む 
玉 ぼ こ の 道 は つ ね に も 惑 は な む 	人 を と ふ と も 我 か と 思 は む 
待 て と 言 は ば 寝 て も ゆ か な む し ひ て 行 く 	駒 の あ し 折 れ 前 の 棚 橋 
あ ふ 坂 の ゆ ふ つ け 鳥 に あ ら ば こ そ 	君 が ゆ き き を な く な く も 見 め 
ふ る さ と に あ ら ぬ も の か ら 我 が た め に 	人 の 心 の 荒 れ て 見 ゆ ら む 
山 が つ の か き ほ に は へ る あ を つ づ ら 	人 は く れ ど も こ と づ て も な し 
大 空 は 恋 し き 人 の 形 見 か は 	物 思 ふ ご と に な が め ら る ら む 
あ ふ ま で の 形 見 も 我 は 何 せ む に 	見 て も 心 の な ぐ さ ま な く に 
あ ふ ま で の 形 見 と て こ そ と ど め け め 	涙 に 浮 ぶ 藻 屑 な り け り 
形 見 こ そ 今 は あ た な れ こ れ な く は 	忘 る る 時 も あ ら ま し も の を 
月 や あ ら ぬ 春 や 昔 の 春 な ら ぬ 	我 が 身 ひ と つ は も と の 身 に し て 
花 薄 我 こ そ 下 に 思 ひ し か 	穂 に い で て 人 に 結 ば れ に け り 
よ そ に の み 聞 か ま し も の を 音 羽 川 	渡 る と な し に 見 な れ そ め け む 
我 が ご と く 我 を 思 は む 人 も が な 	さ て も や 憂 き と 世 を こ こ ろ み む 
久 方 の 天 つ 空 に も す ま な く に 	人 は よ そ に ぞ 思 ふ べ ら な る 
見 て も ま た ま た も 見 ま く の ほ し け れ ば 	な る る を 人 は い と ふ べ ら な り 
雲 も な く な ぎ た る 朝 の 我 な れ や 	い と は れ て の み 世 を ば へ ぬ ら む 
花 が た み 目 な ら ぶ 人 の あ ま た あ れ ば 	忘 ら れ ぬ ら む 数 な ら ぬ 身 は 
う き め の み お ひ て 流 る る 浦 な れ ば 	か り に の み こ そ 海 人 は 寄 る ら め 
あ ひ に あ ひ て 物 思 ふ こ ろ の 我 が 袖 に 	宿 る 月 さ へ 濡 る る か ほ な る 
秋 な ら で 置 く 白 露 は 寝 ざ め す る 	我 が 手 枕 の し づ く な り け り 
須 磨 の 海 人 の 塩 や き 衣 を さ を あ ら み 	ま ど ほ に あ れ や 君 が き ま さ ぬ 
山 し ろ の 淀 の わ か ご も か り に だ に 	来 ぬ 人 た の む 我 ぞ は か な き 
あ ひ 見 ね ば 恋 こ そ ま さ れ み な せ 川 	何 に 深 め て 思 ひ そ め け む 
暁 の し ぎ の 羽 が き も も は が き 	君 が 来 ぬ 夜 は 我 ぞ 数 か く 
玉 か づ ら 今 は 絶 ゆ と や 吹 く 風 の 	音 に も 人 の 聞 こ え ざ る ら む 
我 が 袖 に ま だ き 時 雨 の 降 り ぬ る は 	君 が 心 に 秋 や 来 ぬ ら む 
山 の 井 の 浅 き 心 も 思 は ぬ に 	影 ば か り の み 人 の 見 ゆ ら む 
忘 れ 草 種 と ら ま し を あ ふ こ と の 	い と か く か た き も の と 知 り せ ば 
恋 ふ れ ど も あ ふ 夜 の な き は 忘 れ 草 	夢 ぢ に さ へ や お ひ し げ る ら む 
夢 に だ に あ ふ こ と か た く な り ゆ く は 	我 や い を 寝 ぬ 人 や 忘 る る 
も ろ こ し も 夢 に 見 し か ば 近 か り き 	思 は ぬ な か ぞ は る け か り け る 
ひ と り の み な が め ふ る や の つ ま な れ ば 	人 を し の ぶ の 草 ぞ お ひ け る 
我 が 宿 は 道 も な き ま で 荒 れ に け り 	つ れ な き 人 を 待 つ と せ し ま に 
今 こ む と 言 ひ て 別 れ し あ し た よ り 	思 ひ く ら し の 音 を の み ぞ 鳴 く 
こ め や と は 思 ふ も の か ら ひ ぐ ら し の 	鳴 く 夕 暮 れ は 立 ち 待 た れ つ つ 
今 し は と わ び に し も の を さ さ が に の 	衣 に か か り 我 を た の む る 
今 は こ じ と 思 ふ も の か ら 忘 れ つ つ 	待 た る る こ と の ま だ も や ま ぬ か 
月 夜 に は 来 ぬ 人 待 た る か き く も り 	雨 も 降 ら な む わ び つ つ も 寝 む 
植 ゑ て い に し 秋 田 刈 る ま で 見 え 来 ね ば 	今 朝 初 雁 の 音 に ぞ な き ぬ る 
来 ぬ 人 を 待 つ 夕 暮 れ の 秋 風 は 	い か に 吹 け ば か わ び し か る ら む 
久 し く も な り に け る か な 住 の 江 の 	松 は 苦 し き も の に ぞ あ り け る 
住 の 江 の 松 ほ ど ひ さ に な り ぬ れ ば 	あ し た づ の 音 に な か ぬ 日 は な し 
三 輪 の 山 い か に 待 ち 見 む 年 ふ と も 	た づ ぬ る 人 も あ ら じ と 思 へ ば 
吹 き ま よ ふ 野 風 を 寒 み 秋 萩 の 	う つ り も ゆ く か 人 の 心 の 
今 は と て 我 が 身 時 雨 に ふ り ぬ れ ば 	言 の 葉 さ へ に う つ ろ ひ に け り 
人 を 思 ふ 心 の 木 の 葉 に あ ら ば こ そ 	風 の ま に ま に 散 り も 乱 れ め 
天 雲 の よ そ に も 人 の な り ゆ く か 	さ す が に 目 に は 見 ゆ る も の か ら 
行 き か へ り 空 に の み し て ふ る こ と は 	我 が ゐ る 山 の 風 は や み な り 
唐 衣 な れ ば 身 に こ そ ま つ は れ め 	か け て の み や は 恋 ひ む と 思 ひ し 
秋 風 は 身 を わ け て し も 吹 か な く に 	人 の 心 の 空 に な る ら む 
つ れ も な く な り ゆ く 人 の 言 の 葉 ぞ 	秋 よ り 先 の も み ぢ な り け る 
死 出 の 山 麓 を 見 て ぞ か へ り に し 	つ ら き 人 よ り ま づ 越 え じ と て 
時 す ぎ て 枯 れ ゆ く 小 野 の あ さ ぢ に は 	今 は 思 ひ ぞ 絶 え ず も え け る 
冬 枯 れ の 野 辺 と 我 が 身 を 思 ひ せ ば 	も え て も 春 を 待 た ま し も の を 
水 の 泡 の 消 え て う き 身 と 言 ひ な が ら 	流 れ て な ほ も た の ま る る か な 
み な せ 川 あ り て 行 く 水 な く は こ そ 	つ ひ に 我 が 身 を 絶 え ぬ と 思 は め 
吉 野 川 よ し や 人 こ そ つ ら か ら め 	は や く 言 ひ て し こ と は 忘 れ じ 
世 の 中 の 人 の 心 は 花 染 め の 	う つ ろ ひ や す き 色 に ぞ あ り け る 
心 こ そ う た て に く け れ 染 め ざ ら ば 	う つ ろ ふ こ と も 惜 し か ら ま し や 
色 見 え で う つ ろ ふ も の は 世 の 中 の 	人 の 心 の 花 に ぞ あ り け る 
我 の み や 世 を う ぐ ひ す と な き わ び む 	人 の 心 の 花 と 散 り な ば 
思 ふ と も か れ な む 人 を い か が せ む 	あ か ず 散 り ぬ る 花 と こ そ 見 め 
今 は と て 君 が か れ な ば 我 が 宿 の 	花 を ば ひ と り 見 て や し の ば む 
忘 れ 草 枯 れ も や す る と つ れ も な き 	人 の 心 に 霜 は 置 か な む 
忘 れ 草 何 を か 種 と 思 ひ し は 	つ れ な き 人 の 心 な り け り 
秋 の 田 の い ね て ふ こ と も か け な く に 	何 を 憂 し と か 人 の か る ら む 
初 雁 の 鳴 き こ そ 渡 れ 世 の 中 の 	人 の 心 の 秋 し 憂 け れ ば 
あ は れ と も 憂 し と も 物 を 思 ふ 時 	な ど か 涙 の い と な か る ら む 
身 を 憂 し と 思 ふ に 消 え ぬ も の な れ ば 	か く て も へ ぬ る 世 に こ そ あ り け れ 
海 人 の 刈 る 藻 に す む 虫 の 我 か ら と 	ね を こ そ な か め 世 を ば う ら み じ 
あ ひ 見 ぬ も 憂 き も 我 が 身 の 唐 衣 	思 ひ 知 ら ず も と く る 紐 か な 
つ れ な き を 今 は 恋 ひ じ と 思 へ ど も 	心 弱 く も 落 つ る 涙 か 
人 知 れ ず 絶 え な ま し か ば わ び つ つ も 	な き 名 ぞ と だ に 言 は ま し も の を 
そ れ を だ に 思 ふ こ と と て 我 が 宿 を 	見 き と な 言 ひ そ 人 の 聞 か く に 
あ ふ こ と の も は ら 絶 え ぬ る 時 に こ そ 	人 の 恋 し き こ と も 知 り け れ 
わ び は つ る 時 さ へ も の の か な し き は 	い づ こ を し の ぶ 涙 な る ら む 
う ら み て も 泣 き て も 言 は む 方 ぞ な き 	鏡 に 見 ゆ る 影 な ら ず し て 
夕 さ れ ば 人 な き 床 を う ち は ら ひ 	な げ か む た め と な れ る 我 が 身 か 
わ た つ み の 我 が 身 こ す 浪 立 ち 返 り 	海 人 の 住 む て ふ う ら み つ る か な 
あ ら を 田 を あ ら す き か へ し か へ し て も 	人 の 心 を 見 て こ そ や ま め 
あ り そ 海 の 浜 の 真 砂 と た の め し は 	忘 る る こ と の 数 に ぞ あ り け る 
葦 辺 よ り 雲 ゐ を さ し て 行 く 雁 の 	い や 遠 ざ か る 我 が 身 か な し も 
時 雨 つ つ も み づ る よ り も 言 の 葉 の 	心 の 秋 に あ ふ ぞ わ び し き 
秋 風 の 吹 き と 吹 き ぬ る 武 蔵 野 は 	な べ て 草 葉 の 色 か は り け り 
秋 風 に あ ふ た の み こ そ か な し け れ 	我 が 身 む な し く な り ぬ と 思 へ ば 
秋 風 の 吹 き 裏 返 す く ず の 葉 の 	う ら み て も な ほ う ら め し き か な 
秋 と 言 へ ば よ そ に ぞ 聞 き し あ だ 人 の 	我 を ふ る せ る 名 に こ そ あ り け れ 
忘 ら る る 身 を 宇 治 橋 の な か 絶 え て 	人 も か よ は ぬ 年 ぞ へ に け る 
あ ふ こ と を 長 柄 の 橋 の な が ら へ て 	恋 ひ 渡 る 間 に 年 ぞ へ に け る 
浮 き な が ら け ぬ る 泡 と も な り な な む 	流 れ て と だ に た の ま れ ぬ 身 は 
流 れ て は 妹 背 の 山 の な か に 落 つ る 	吉 野 の 川 の よ し や 世 の 中 
泣 く 涙 雨 と 降 ら な む わ た り 川 	水 ま さ り な ば か へ り く る が に 
血 の 涙 落 ち て ぞ た ぎ つ 白 川 は 	君 が 世 ま で の 名 に こ そ あ り け れ 
空 蝉 は 殻 を 見 つ つ も な ぐ さ め つ 	深 草 の 山 煙 だ に た て 
深 草 の 野 辺 の 桜 し 心 あ ら ば 	今 年 ば か り は 墨 染 め に 咲 け 
寝 て も 見 ゆ 寝 で も 見 え け り お ほ か た は 	空 蝉 の 世 ぞ 夢 に は あ り け る 
夢 と こ そ 言 ふ べ か り け れ 世 の 中 に 	う つ つ あ る も の と 思 ひ け る か な 
寝 る が 内 に 見 る を の み や は 夢 と 言 は む 	は か な き 世 を も う つ つ と は 見 ず 
瀬 を せ け ば 淵 と な り て も 淀 み け り 	別 れ を 止 む る し が ら み ぞ な き 
先 立 た ぬ く い の や ち た び か な し き は 	流 る る 水 の か へ り 来 ぬ な り 
明 日 知 ら ぬ 我 が 身 と 思 へ ど 暮 れ ぬ 間 の 	今 日 は 人 こ そ か な し か り け れ 
時 し も あ れ 秋 や は 人 の 別 る べ き 	あ る を 見 る だ に 恋 し き も の を 
神 無 月 時 雨 に 濡 る る も み ぢ 葉 は 	た だ わ び 人 の 袂 な り け り 
藤 衣 は つ る る 糸 は わ び 人 の 	涙 の 玉 の 緒 と ぞ な り け る 
朝 露 の お く て の 山 田 か り そ め に 	う き 世 の 中 を 思 ひ ぬ る か な 
墨 染 め の 君 が 袂 は 雲 な れ や 	絶 え ず 涙 の 雨 と の み 降 る 
あ し ひ き の 山 辺 に 今 は 墨 染 め の 	衣 の 袖 は ひ る 時 も な し 
水 の 面 に し づ く 花 の 色 さ や か に も 	君 が 御 影 の 思 ほ ゆ る か な 
草 深 き 霞 の 谷 に か げ 隠 し 	照 る 日 の 暮 れ し 今 日 に や は あ ら ぬ 
み な 人 は 花 の 衣 に な り ぬ な り 	苔 の 袂 よ 乾 き だ に せ よ 
う ち つ け に さ び し く も あ る か も み ぢ 葉 も 	主 な き 宿 は 色 な か り け り 
郭 公 今 朝 鳴 く 声 に お ど ろ け ば 	君 に 別 れ し 時 に ぞ あ り け る 
花 よ り も 人 こ そ あ だ に な り に け れ 	い づ れ を 先 に 恋 ひ む と か 見 し 
色 も 香 も 昔 の 濃 さ に 匂 へ ど も 	植 ゑ け む 人 の 影 ぞ 恋 し き 
君 ま さ で 煙 絶 え に し 塩 釜 の 	う ら さ び し く も 見 え 渡 る か な 
君 が 植 ゑ し ひ と む ら 薄 虫 の 音 の 	し げ き 野 辺 と も な り に け る か な 
こ と な ら ば 言 の 葉 さ へ も 消 え な な む 	見 れ ば 涙 の 滝 ま さ り け り 
な き 人 の 宿 に か よ は ば 郭 公 	か け て 音 に の み な く と つ げ な む 
誰 見 よ と 花 咲 け る ら む 白 雲 の 	た つ 野 と は や く な り に し も の を 
か ず か ず に 我 を 忘 れ ぬ も の な ら ば 	山 の 霞 を あ は れ と は 見 よ 
声 を だ に 聞 か で 別 る る た ま よ り も 	な き 床 に 寝 む 君 ぞ か な し き 
も み ぢ 葉 を 風 に ま か せ て 見 る よ り も 	は か な き も の は 命 な り け り 
露 を な ど あ だ な る も の と 思 ひ け む 	我 が 身 も 草 に 置 か ぬ ば か り を 
つ ひ に ゆ く 道 と は か ね て 聞 き し か ど 	昨 日 今 日 と は 思 は ざ り し を 
か り そ め の 行 き か ひ ぢ と ぞ 思 ひ こ し 	今 は か ぎ り の 門 出 な り け り 
我 が 上 に 露 ぞ 置 く な る 天 の 河 	と 渡 る 舟 の 櫂 の し づ く か 
お も ふ ど ち ま と ゐ せ る 夜 は 唐 錦 	た た ま く 惜 し き も の に ぞ あ り け る 
う れ し き を 何 に つ つ ま む 唐 衣 	袂 ゆ た か に た て と 言 は ま し を 
か ぎ り な き 君 が た め に と 折 る 花 は 	時 し も わ か ぬ も の に ぞ あ り け る 
紫 の ひ と も と ゆ ゑ に 武 蔵 野 の 	草 は み な が ら あ は れ と ぞ 見 る 
紫 の 色 濃 き 時 は め も は る に 	野 な る 草 木 ぞ 別 れ ざ り け る 
色 な し と 人 や 見 る ら む 昔 よ り 	深 き 心 に 染 め て し も の を 
日 の 光 藪 し わ か ね ば い そ の か み 	ふ り に し 里 に 花 も 咲 き け り 
大 原 や を し ほ の 山 も 今 日 こ そ は 	神 世 の こ と も 思 ひ い づ ら め 
天 つ 風 雲 の か よ ひ ぢ 吹 き と ぢ よ 	乙 女 の 姿 し ば し と ど め む 
主 や 誰 問 へ ど 白 玉 言 は な く に 	さ ら ば な べ て や あ は れ と 思 は む 
玉 だ れ の こ が め や い づ ら こ よ ろ ぎ の 	磯 の 浪 わ け 沖 に い で に け り 
か た ち こ そ み 山 隠 れ の 朽 ち 木 な れ 	心 は 花 に な さ ば な り な む 
蝉 の 羽 の 夜 の 衣 は 薄 け れ ど 	移 り 香 濃 く も 匂 ひ ぬ る か な 
遅 く い づ る 月 に も あ る か な あ し ひ き の 	山 の あ な た も 惜 し む べ ら な り 
我 が 心 な ぐ さ め か ね つ 更 級 や 	を ば す て 山 に 照 る 月 を 見 て 
お ほ か た は 月 を も め で じ こ れ ぞ こ の 	つ も れ ば 人 の 老 い と な る も の 
か つ 見 れ ば う と く も あ る か な 月 影 の 	い た ら ぬ 里 も あ ら じ と 思 へ ば 
ふ た つ な き も の と 思 ひ し を 水 底 に 	山 の 端 な ら で い づ る 月 影 
天 の 河 雲 の み を に て は や け れ ば 	光 と ど め ず 月 ぞ 流 る る 
あ か ず し て 月 の 隠 る る 山 も と は 	あ な た お も て ぞ 恋 し か り け る 
あ か な く に ま だ き も 月 の 隠 る る か 	山 の 端 逃 げ て 入 れ ず も あ ら な む 
大 空 を 照 り ゆ く 月 し 清 け れ ば 	雲 隠 せ ど も 光 け な く に 
い そ の か み ふ る か ら 小 野 の も と か し は 	も と の 心 は 忘 ら れ な く に 
い に し へ の 野 中 の 清 水 ぬ る け れ ど 	も と の 心 を 知 る 人 ぞ く む 
い に し へ の し づ の を だ ま き い や し き も 	よ き も さ か り は あ り し も の な り 
今 こ そ あ れ 我 も 昔 は 男 山 	さ か ゆ く 時 も あ り こ し も の を 
世 の 中 に ふ り ぬ る も の は 津 の 国 の 	長 柄 の 橋 と 我 と な り け り 
笹 の 葉 に 降 り つ む 雪 の う れ を 重 み 	も と く だ ち ゆ く 我 が さ か り は も 
大 荒 木 の も り の 下 草 お い ぬ れ ば 	駒 も す さ め ず か る 人 も な し 
か ぞ ふ れ ば と ま ら ぬ も の を 年 と い ひ て 	今 年 は い た く 老 い ぞ し に け る 
お し て る や 難 波 の 水 に 焼 く 塩 の 	か ら く も 我 は 老 い に け る か な 
老 い ら く の 来 む と 知 り せ ば 門 さ し て 	な し と 答 へ て あ は ざ ら ま し を 
さ か さ ま に 年 も ゆ か な む と り も あ へ ず 	す ぐ る 齢 や と も に か へ る と 
と り と む る も の に し あ ら ね ば 年 月 を 	あ は れ あ な う と す ぐ し つ る か な 
と ど め あ へ ず む べ も 年 と は い は れ け り 	し か も つ れ な く す ぐ る 齢 か 
鏡 山 い ざ 立 ち 寄 り て 見 て ゆ か む 	年 へ ぬ る 身 は 老 い や し ぬ る と 
老 い ぬ れ ば さ ら ぬ 別 れ も あ り と 言 へ ば 	い よ い よ 見 ま く ほ し き 君 か な 
世 の 中 に さ ら ぬ 別 れ の な く も が な 	千 代 も と な げ く 人 の 子 の た め 
白 雪 の 八 重 降 り し け る か へ る 山 	か へ る が へ る も 老 い に け る か な 
老 い ぬ と て な ど か 我 が 身 を せ め き け む 	老 い ず は 今 日 に あ は ま し も の か 
ち は や ぶ る 宇 治 の 橋 守 な れ を し ぞ 	あ は れ と は 思 ふ 年 の へ ぬ れ ば 
我 見 て も 久 し く な り ぬ 住 の 江 の 	岸 の 姫 松 幾 世 へ ぬ ら む 
住 吉 の 岸 の 姫 松 人 な ら ば 	幾 世 か へ し と 問 は ま し も の を 
梓 弓 磯 辺 の 小 松 た が 世 に か 	よ ろ づ 世 か ね て 種 を ま き け む 
か く し つ つ 世 を や つ く さ む 高 砂 の 	尾 上 に 立 て る 松 な ら な く に 
誰 を か も 知 る 人 に せ む 高 砂 の 	松 も 昔 の 友 な ら な く に 
わ た つ み の 沖 つ 潮 あ ひ に 浮 か ぶ 泡 の 	消 え ぬ も の か ら 寄 る 方 も な し 
わ た つ み の か ざ し に さ せ る 白 妙 の 	浪 も て ゆ へ る 淡 路 島 山 
わ た の 原 寄 せ く る 浪 の し ば し ば も 	見 ま く の ほ し き 玉 津 島 か も 
難 波 潟 潮 満 ち く ら し 雨 衣 	た み の の 島 に た づ 鳴 き 渡 る 
君 を 思 ひ お き つ の 浜 に 鳴 く た づ の 	尋 ね く れ ば ぞ あ り と だ に 聞 く 
沖 つ 浪 た か し の 浜 の 浜 松 の 	名 に こ そ 君 を 待 ち わ た り つ れ 
難 波 潟 お ふ る 玉 藻 を か り そ め の 	海 人 と ぞ 我 は な り ぬ べ ら な る 
住 吉 と 海 人 は 告 ぐ と も 長 居 す な 	人 忘 れ 草 お ふ と 言 ふ な り 
雨 に よ り た み の の 島 を 今 日 ゆ け ど 	名 に は 隠 れ ぬ も の に ぞ あ り け る 
あ し た づ の 立 て る 川 辺 を 吹 く 風 に 	寄 せ て か へ ら ぬ 浪 か と ぞ 見 る 
水 の 上 に 浮 か べ る 舟 の 君 な ら ば 	こ こ ぞ と ま り と 言 は ま し も の を 
み や こ ま で ひ び き か よ へ る か ら こ と は 	浪 の を す げ て 風 ぞ ひ き け る 
こ き 散 ら す 滝 の 白 玉 拾 ひ お き て 	世 の 憂 き 時 の 涙 に ぞ か る 
ぬ き 乱 る 人 こ そ あ る ら し 白 玉 の 	ま な く も 散 る か 袖 の せ ば き に 
誰 が た め に 引 き て さ ら せ る 布 な れ や 	世 を へ て 見 れ ど と る 人 も な き 
清 滝 の 瀬 ぜ の 白 糸 く り た め て 	山 わ け ご ろ も 織 り て 着 ま し を 
た ち ぬ は ぬ 衣 着 し 人 も な き も の を 	な に 山 姫 の 布 さ ら す ら む 
主 な く て さ ら せ る 布 を 七 夕 に 	我 が 心 と や 今 日 は か さ ま し 
落 ち た ぎ つ 滝 の 水 上 年 つ も り 	老 い に け ら し な 黒 き 筋 な し 
風 吹 け ど と こ ろ も 去 ら ぬ 白 雲 は 	世 を へ て 落 つ る 水 に ぞ あ り け る 
思 ひ せ く 心 の 内 の 滝 な れ や 	落 つ と は 見 れ ど 音 の 聞 こ え ぬ 
咲 き そ め し 時 よ り の ち は う ち は へ て 	世 は 春 な れ や 色 の 常 な る 
か り て ほ す 山 田 の 稲 の こ き た れ て 	な き こ そ わ た れ 秋 の 憂 け れ ば 
世 の 中 は 何 か 常 な る 飛 鳥 川 	昨 日 の 淵 ぞ 今 日 は 瀬 に な る 
幾 世 し も あ ら じ 我 が 身 を な ぞ も か く 	海 人 の 刈 る 藻 に 思 ひ 乱 る る 
雁 の 来 る 峰 の 朝 霧 晴 れ ず の み 	思 ひ つ き せ ぬ 世 の 中 の 憂 さ 
し か り と て そ む か れ な く に こ と し あ れ ば 	ま づ な げ か れ ぬ あ な う 世 の 中 
み や こ 人 い か が と 問 は ば 山 高 み 	晴 れ ぬ 雲 ゐ に わ ぶ と 答 へ よ 
わ び ぬ れ ば 身 を 浮 草 の 根 を 絶 え て 	さ そ ふ 水 あ ら ば い な む と ぞ 思 ふ 
あ は れ て ふ こ と こ そ う た て 世 の 中 を 	思 ひ は な れ ぬ ほ だ し な り け れ 
あ は れ て ふ 言 の 葉 ご と に 置 く 露 は 	昔 を 恋 ふ る 涙 な り け り 
世 の 中 の う き も つ ら き も 告 げ な く に 	ま づ 知 る も の は 涙 な り け り 
世 の 中 は 夢 か う つ つ か う つ つ と も 	夢 と も 知 ら ず あ り て な け れ ば 
世 の 中 に い づ ら 我 が 身 の あ り て な し 	あ は れ と や 言 は む あ な う と や 言 は む 
山 里 は も の の わ び し き こ と こ そ あ れ 	世 の 憂 き よ り は 住 み よ か り け り 
白 雲 の 絶 え ず た な び く 峰 に だ に 	住 め ば 住 み ぬ る 世 に こ そ あ り け れ 
知 り に け む 聞 き て も い と へ 世 の 中 は 	浪 の 騒 ぎ に 風 ぞ し く め る 
い づ こ に か 世 を ば い と は む 心 こ そ 	野 に も 山 に も 惑 ふ べ ら な れ 
世 の 中 は 昔 よ り や は う か り け む 	我 が 身 ひ と つ の た め に な れ る か 
世 の 中 を い と ふ 山 辺 の 草 木 と や 	あ な う の 花 の 色 に い で に け む 
み 吉 野 の 山 の あ な た に 宿 も が な 	世 の 憂 き 時 の 隠 れ が に せ む 
世 に ふ れ ば 憂 さ こ そ ま さ れ み 吉 野 の 	岩 の か け 道 踏 み な ら し て む 
い か な ら む 巌 の 中 に 住 ま ば か は 	世 の 憂 き こ と の 聞 こ え こ ざ ら む 
あ し ひ き の 山 の ま に ま に 隠 れ な む 	う き 世 の 中 は あ る か ひ も な し 
世 の 中 の う け く に あ き ぬ 奥 山 の 	木 の 葉 に 降 れ る 雪 や け な ま し 
世 の う き め 見 え ぬ 山 ぢ へ 入 ら む に は 	思 ふ 人 こ そ ほ だ し な り け れ 
世 を 捨 て て 山 に い る 人 山 に て も 	な ほ 憂 き 時 は い づ ち 行 く ら む 
今 さ ら に な に お ひ い づ ら む 竹 の 子 の 	う き 節 し げ き 世 と は 知 ら ず や 
世 に ふ れ ば 言 の 葉 し げ き 呉 竹 の 	う き 節 ご と に う ぐ ひ す ぞ 鳴 く 
木 に も あ ら ず 草 に も あ ら ぬ 竹 の よ の 	端 に 我 が 身 は な り ぬ べ ら な り 
我 が 身 か ら う き 世 の 中 と 名 づ け つ つ 	人 の た め さ へ か な し か る ら む 
思 ひ き や ひ な の 別 れ に お と ろ へ て 	海 人 の 縄 た き い さ り せ む と は 
わ く ら ば に 問 ふ 人 あ ら ば 須 磨 の 浦 に 	藻 塩 た れ つ つ わ ぶ と 答 へ よ 
天 彦 の お と づ れ じ と ぞ 今 は 思 ふ 	我 か 人 か と 身 を た ど る 世 に 
う き 世 に は 門 さ せ り と も 見 え な く に 	な ど か 我 が 身 の い で が て に す る 
あ り は て ぬ 命 待 つ 間 の ほ ど ば か り 	う き こ と し げ く 思 は ず も が な 
つ く ば ね の 木 の も と ご と に 立 ち ぞ 寄 る 	春 の み 山 の か げ を 恋 つ つ 
光 な き 谷 に は 春 も よ そ な れ ば 	咲 き て と く 散 る 物 思 ひ も な し 
久 方 の 中 に お ひ た る 里 な れ ば 	光 を の み ぞ た の む べ ら な る 
今 ぞ 知 る 苦 し き も の と 人 待 た む 	里 を ば か れ ず 問 ふ べ か り け り 
忘 れ て は 夢 か と ぞ 思 ふ 思 ひ き や 	雪 踏 み わ け て 君 を 見 む と は 
年 を へ て 住 み こ し 里 を い で て い な ば 	い と ど 深 草 野 と や な り な む 
野 と な ら ば う づ ら と な き て 年 は へ む 	か り に だ に や は 君 が こ ざ ら む 
我 を 君 難 波 の 浦 に あ り し か ば 	う き め を み つ の 海 人 と な り に き 
難 波 潟 う ら む べ き ま も 思 ほ え ず 	い づ こ を み つ の 海 人 と か は な る 
今 さ ら に 問 ふ べ き 人 も 思 ほ え ず 	八 重 む ぐ ら し て 門 さ せ り て へ 
水 の 面 に お ふ る 五 月 の 浮 草 の 	う き こ と あ れ や 根 を 絶 え て 来 ぬ 
身 を 捨 て て ゆ き や し に け む 思 ふ よ り 	外 な る も の は 心 な り け り 
君 が 思 ひ 雪 と つ も ら ば た の ま れ ず 	春 よ り の ち は あ ら じ と 思 へ ば 
君 を の み 思 ひ こ し ぢ の 白 山 は 	い つ か は 雪 の 消 ゆ る 時 あ る 
思 ひ や る 越 の 白 山 知 ら ね ど も 	ひ と 夜 も 夢 に 越 え ぬ 夜 ぞ な き 
い ざ こ こ に 我 が 世 は へ な む 菅 原 や 	伏 見 の 里 の 荒 れ ま く も 惜 し 
我 が 庵 は 三 輪 の 山 も と 恋 し く は 	と ぶ ら ひ き ま せ 杉 た て る 門 
我 が 庵 は み や こ の た つ み し か ぞ す む 	世 を う ぢ 山 と 人 は 言 ふ な り 
荒 れ に け り あ は れ 幾 世 の 宿 な れ や 	住 み け む 人 の お と づ れ も せ ぬ 
わ び 人 の 住 む べ き 宿 と 見 る な へ に 	嘆 き く は は る 琴 の 音 ぞ す る 
人 ふ る す 里 を い と ひ て こ し か ど も 	奈 良 の み や こ も う き 名 な り け り 
世 の 中 は い づ れ か さ し て 我 が な ら む 	行 き と ま る を ぞ 宿 と さ だ む る 
あ ふ 坂 の 嵐 の 風 は 寒 け れ ど 	ゆ く へ 知 ら ね ば わ び つ つ ぞ 寝 る 
風 の 上 に あ り か さ だ め ぬ 塵 の 身 は 	ゆ く へ も 知 ら ず な り ぬ べ ら な り 
飛 鳥 川 淵 に も あ ら ぬ 我 が 宿 も 	瀬 に か は り ゆ く も の に ぞ あ り け る 
ふ る さ と は 見 し ご と も あ ら ず 斧 の 柄 の 	朽 ち し と こ ろ ぞ 恋 し か り け る 
あ か ざ り し 袖 の 中 に や 入 り に け む 	我 が た ま し ひ の な き 心 地 す る 
な よ 竹 の よ 長 き 上 に 初 霜 の 	お き ゐ て 物 を 思 ふ こ ろ か な 
風 吹 け ば 沖 つ 白 浪 た つ た 山 	夜 半 に や 君 が ひ と り こ ゆ ら む 
た が み そ ぎ ゆ ふ つ け 鳥 か 唐 衣 	た つ た の 山 に を り は へ て 鳴 く 
忘 ら れ む 時 し の べ と ぞ 浜 千 鳥 	ゆ く へ も 知 ら ぬ 跡 を と ど む る 
神 無 月 時 雨 降 り お け る な ら の 葉 の 	名 に お ふ 宮 の ふ る こ と ぞ こ れ 
あ し た づ の ひ と り お く れ て 鳴 く 声 は 	雲 の 上 ま で 聞 こ え つ が な む 
人 知 れ ず 思 ふ 心 は 春 霞 	た ち い で て 君 が 目 に も 見 え な む 
山 川 の 音 に の み 聞 く も も し き を 	身 を は や な が ら 見 る よ し も が な 
